Little Door Gods	小門神
A Bite of China: Celebrating the Chinese New Year	舌尖上的新年
Strange Battle	荒村怨靈
The Secret	控制
Royal Treasure	極限挑戰之皇家寶藏
Love Godfathers	戀愛教父之三個壞傢伙
Chinese Wine	國酒
I'm Handsome	我很帥
Boonie Bears III	熊出沒之熊心歸來
Inside or Outside	真相禁區
The Family Running Forward	一家老小向前沖
Love in Late Autumn	愛在深秋
The Big Lie Bang	謊言大爆炸
Please Open Your Window	請把你的窗戶打開
The Apparition	幻影
Dad, I Will Rescue You	爸爸我來救你了
House Of Wolves	惡人谷
Fruity Robo The Great Escape	果寶特攻之水果第三集中營
The Ape Story	猿創世界之熊孩子部落
My Friends	我的「狐朋狗友」
For Love	致我們終將到來的愛情
Youth in the Air Outlet	風口青春
Lost in the Pacific	蒸發太平洋
Out of Ordinary	非同小可
The New Year's Eve of Old Lee	過年好
Mermaid	我的人魚女友
The Monkey King 2	西遊記之孫悟空三打白骨精
From Vegas to Macau III	賭城風雲III
Mr. Nian	年獸大作戰
Run for Love	奔愛
Kill Time	謀殺似水年華
Mr. Highheels	高跟鞋先生
Crouching Tiger, Hidden Dragon: Sword of Destiny	臥虎藏龍：青冥寶劍
The Frog Kingdom 2: Sub-Zero Mission	青蛙王國之冰凍大冒險
The Game	致命怪談
Money and Love	恭喜發財之談錢說愛
When We Were Young	不朽的時光
The Weird Doll	詭娃
Kick Ass Girls	爆3俏嬌娃
Ip Man 3	葉問3
You Really Are My Lover	你是不是我的愛人
Spicy hot in love	愛情麻辣燙之情定終身
She Remembers, He Forgets	哪一天我們會飛
Judge Archer	箭士柳白猿
Wang Mao	我不是王毛
Guia in Love	燈塔下的戀人
Love Studio	同城邂逅
Under The Bed 3	床下有人3
Don't Run the Thief	笨賊別跑
Dumb Child	啞孩兒
Wong Ka Yan	王家欣
The Rise of a Tomboy	女漢子真愛公式
Red Cheongsam	恐怖禁忌之紅旗袍
Papa	洛杉磯搗蛋計劃
Road to the Sky	情比山高
Girls Generation	半熟少女
Fear Is Coming	恐怖將映
Easy Life	喜樂長安
Hui Xiang Dou	回鄉逗兒
The White-haired Girl	白毛女
One Night of Fate	一夜危機
The Bodyguard	特工爺爺
The Guest	神秘訪客
Who Sleeps My Bro	睡在我上鋪的兄弟
Chongqing Hot Pot	火鍋英雄
Xuan Yuan the Great Emperor	軒轅大帝
Space Panda	太空熊貓歷險記
My Wife is a Superstar	我老婆是明星
Midnight Record Search	午夜尋訪錄
The Little	小角色
Ghost Neighbor	隔壁驚魂
Mother's Revenge	貓臉老太太
The Deadly Reasoning	奪命推理
New York New York	紐約紐約
Lost In White	冰河追兇
My New Sassy Girl	我的新野蠻女友
Yesterday Once More	誰的青春不迷茫
Buddy Cops	刑警兄弟
My Ten Million	我的1000萬
Insomnia Lover	失眠男女
Music And Dream	恐怖照相機
Goodess Era	女神時代
Finding Mr. Right 2	北京遇上西雅圖之不二情書
Xuan Zang	大唐玄奘
MBA Partners	夢想合伙人
Phantom of the Theatre	魔宮魅影
Ma Xiaole and His Toys	馬小樂之玩具也瘋狂
Adventure of Frog	青蛙總動員
Alibaba 2 solomon seal	阿里巴巴2所羅門封印
Wind Chimes On The Card	風鈴上的卡片
Song of the Phoenix	百鳥朝鳳
Bujilan	布基蘭
Sentence Me Guilty	判我有罪
God’s Hug	男神抱抱
Heaven of Nestling	雛鳥的天空
Distance	再見，在也不見
Don't Open The Door	別開門
Bloody House	筆仙詭影
22nd Catch	22個男人
Brothers	鋼刀
Night Peacock	夜孔雀
708090 Love Story of Shenzhen	708090之深圳戀歌
Plastic Surgeon·Hunted Face	整形師·臉
Self Redemption	自我救贖
A Horse with Hope	山那邊有匹馬
Witch Doctor	妖醫
Murder At Honeymoon Hotel	蜜月酒店殺人事件
Jungle Master&#160;: the Candy World	糖果世界大冒險
Star Ant - Global Adventure	小螞蟻之環球大冒險
Compass	鬥龍戰士之星印羅盤
Fruit Story	水果寶貝之水果總動員
Floraand Fauna’s War	動植物大戰
Memento Mori	記憶拼圖
The Death Game	死亡遊戲
ATM	提款機
Toys War	泰迪熊之玩具大戰
Our graduation	我們畢業啦
The Curse of Chopsticks	筷仙
When the Meteor Shot Across the Sky	當流星划過天際
One Night	練膽兒
The flowers blooming	山花爛漫時
Love of the Sea	海洋之戀
Warrior VS Dragon	我叫MT之山口山戰記
Nankou in 1937	南口1937
Three	三人行
Close To You	近在咫尺的愛侶
Da Huo Zhong	大火種
So, I Married the Anti-fan	所以……和黑粉結婚了
Bounty Hunters	賞金獵人
The Precipice Game	魔輪
The Last Race	終極勝利
The Death War	絕戰
Scary Notes	恐怖筆記
Yin Lingzhi	黨的女兒尹靈芝
The adventures of the ugly duckling	醜小鴨歷險記
Foolish Plans	發條城市
Never Gone	致青春·原來你還在這裡
Cold War II	寒戰2
ChangChenGhostStories	張震講故事之合租屋
Da Hai	大魚海棠
Following the Donkey	人在驢途
Joy of Seconf Child	再生之樂
Kaili Blues	路邊野餐
Tik Tok	驚天大逆轉
For A Few Bullets	快手槍手快槍手
When Larry Met Mary	陸垚知馬俐
Fairy Impac Disc Fairy	筆仙撞碟仙
Master of Pretending	假裝看不見之電影大師
Summer's Desire	泡沫之夏
Skiptrace	絕地逃亡
One Night Only	天亮之前
Horror Love Story Wrong Way	恐怖愛情故事之死亡公路
The Whisper	魔都凶音
The young touts the big Yu treasure	少年師爺之大禹寶藏
Spiny Life	刺蝟小子之天生我刺
At Cafe 6	六弄咖啡館
League of Gods	封神傳奇
Girl of the Big House	寶貝當家
Warrant the Reborn	催命符之劫後重生
A Busy Night	情況不妙
Toxic Poisoning	毒中毒
Yugo & Lala 3	神秘世界歷險記3
Kungfu Boys	龍拳小子
A Roar of Wolf Troops	狼兵吼
The Lost Tomb	盜墓筆記
Sweet Sixteen	夏有喬木，雅望天堂
My Best Friend’s Wedding	我最好朋友的婚禮
Golden Doll	古曼
Never Said Goodbye	謊言西西里
Line Walker	使徒行者
Love O2O	微微一笑很傾城
I Love That Crazy Little Thing	那件瘋狂的小事叫愛情
Lost in Island	島囧
Call of Heroes	危城
Born in China	我們誕生在中國
A Wishing Tree	一棵心中的許願樹
Past and Present	七月半2：前世今生
Ultimate hero	終極硬漢
New Happy Dad and Son 2: The Instant Genius	新大頭兒子小頭爸爸2一日成才
Angel Please Kiss Me	天使請吻我
Green Lover	低碳愛情
Mountain Cry	喊·山
Crying Out In Love	在世界中心呼喚愛
Happiness	幸運是我
Dad's Cabin	爸爸的木房子
The Weird Bride	詭新娘
Elanne Starlight	愛在星空下
Crazy Crazy	瘋狂的瘋狂
Snow White And The Three Pigs	白雪公主和三隻小豬
Change A Life-style	換個活法
Days of Our Own	我們的十年
Battle of Cuju	蹴鞠
Who is Crying at Midnight	夜半哭聲
The Magic of Children&#160;: Magic Attack	小魔仙之黑魔法來襲
See You I See Me!	看見我和你
Crosscurrent	長江圖
Two Idiots	傻瓜向錢衝
For Love to Let Go	為愛放手
Horrible Masion In Wild Village	荒村凶間
A Woman in the Shadow	夜魔人
The Beauty	鬥豔
Silk Road Hero: Khan's Arrow	絲路英雄·雲鏑
Soul Mate	七月與安生
Cock and Bull	追兇者也
A Chinese Odyssey Part III	大話西遊3
S Strom	S風暴
My War	我的戰爭
A Dog Named Wang Zi	一條叫王子的狗
Ai De Xie Hou	愛的蟹逅
Godbeast Megazord: Return of Green Dragon	神獸金剛之青龍再現
Rise of The Rice Cooker	麥兜．飯寶奇兵
The Match	擊戰
The Nightmare Call	詭夢凶鈴
Another Woman	234說愛你
The Unvanished Vapour	誰的青春不熱血之深流不息
Three Idiots	三個孬傢伙
I Belonged to You	從你的全世界路過
L.O.R.D: Legend of Ravaging Dynasties	爵跡
Operation Mekong	湄公河行動
Ghost Hospital	幽靈醫院
The Bell Of Love	愛的鐘聲
The New Pinocchio	新木偶奇遇記
Mission Milano	偷天特務
Mind Decoding	心靈解碼
I Am NeZha	我是哪吒
Armor Hero Captor King	鎧甲勇士捕王
The Ugly Duckling	瘋狂醜小鴨
The Voice	愛情不等式
The New Orient Shenwa	新東方神娃
The Promise I Made to You	那年我對你的承諾
What's in the Darkness	黑處有什麼
Xiao Xiong De Xia Tian	小熊的夏天
Fall in Love	愛上處女座
Super Model	T台魔王
Cupid Arrow	愛神箭
Heart With The Sun	心語陽光
River of Belief	太陽河
Heartfall Arises	破地獄
Nessun Dorma	兇手還未睡
Flipped	怦然心動
Roommates in Love	異性合租的往事
So Luckly	槓上開花
Lei Feng Man	熱血雷鋒俠之激情營救
Triumphantly Join Forces	大會師
Mr. Donkey	驢得水
The Nursery	育嬰室
Mysterious Fece II	枕邊有張臉2
The Loner	何去何從
Xiaoming & His Friends	小明和他的小夥伴們
Looking For The Holy Land	我的聖途
Hide and Seek	非常父子檔
Never Give Up	不離不棄
The Song Of Cotton	盛先生的花兒
Funny Soccer	笑林足球
Curse of the Demon	詭咒
Hijack	被劫持的愛情
Shadow	獄中驚魂
96 Hours	生死96小時
PoorRich Dad	貧窮富爸爸
Escape Route	奪路而逃
The Light	減法人生
Scandal Maker	外公芳齡38
The Bride With Painted Skin	聊齋新編之畫皮新娘
The Brothers-The Drifting Singer In Beijing	兄弟之北漂歌手
I Do Want My Money Back	非常綁架
De-Single Bible	脫單寶典
Last Testimony	最後證言
Hong Yan Rong	紅顏容
I Am Not Madame Bovary	我不是潘金蓮
The Warriors Gate	勇士之門
Special Female Force	辣警霸王花
Wu Lin Tan Mi	武林探秘
Sky On Fire	沖天火
MIN & MAX	最萌身高差
Perfect Imperfection	我是處女座
Soul House	怨靈地下室
An Flying Arrow	駱駝客2之箭在弦
Lost in Vietnam	越囧
The Elegy	熱土悲歌
My Love	愛你的人
Sword Master	三少爺的劍
Super Express	超級快遞
Ghost	食人島
The heart of desert	沙漠之心
Yellow River Aria	老腔
Prince Orient House	東宮皇子
48Hours	試睡員48小時
Suddenly Seventeen	28歲未成年
Tharlo	塔洛
Foolish Plan	呆呆計劃
Room 704	淒靈室
Somewhere Connected	那美
Rescripts Bout Peony Fairy	牡丹仙子之皇帝昭曰
Good Night	愛上試睡師
Young	先鋒之那時青春
Revenge of Gold	流金
The Great Wall	長城
The Wasted Times	羅曼蒂克消亡史
Blood of Youth	少年
My Circle of Friends	我的朋友圈
Flying Girl	飛天窯女
Five Besties: Divorce Busting	五女鬧京城
Masters In Forbidden City	我在故宮修文物
This is Life	生門
Kunfu Heros	功夫四俠
Sweet of the Song	甜水謠
Spring of the Life	大山裡的春天
See You Tomorrow	擺渡人
Railroad Tigers	鐵道飛虎
The Writing's On The Wall	有跡可循
Lost Minds	失心者
My Super Girl	我的女神女漢子
Provoking Laughter	冒牌臥底
Some Like It Hot	情聖
Three Weddings	爸爸的3次婚禮
Cherry Returns	那年夏天你去了哪裡
Unforgettable Golden Beach	難忘金銀灘
The Insanity	你好，瘋子！
She's From Another Planet	人魚校花
Super Kindergarten	超級幼兒園
The Ghouls	尋龍訣
The Gigolo 2	鴨王2
Goodbye Mr. Loser	夏洛特煩惱
Love in the Late Autumn	愛在深秋
Mr. Six	老炮兒
Les Aventures D'Anthony	陪安東尼度過漫長歲月
The Last Woman Standing	剩者為王
GATAO	角頭
The Mermaid	美人魚
PG Love	PG戀愛指引
Bully	施壓者
i Girl	iGirl 夢情人
The Tag-Along	紅衣小女孩
Heaven In The Dark	暗色天堂
Wawa No Cidal	太陽的孩子
The Mobfathers	選老頂
Trivisa	樹大招風
Robbery	老笠
In The Room	無限春光27
The Kid From The Big Apple	我來自紐約
My Wife Is A Superstar	我老婆係明星
Good Take Too	打開我天空
The Taste of Youth	少年滋味
Kidnap Ding Ding Don	綁架丁丁當
Detective Chinatown	唐人街探案
Cold War 2	寒戰
Wansei Back Home	灣生回家
League Of Gods	封神傳奇
The Menu	導火新聞線
The Tenants Downstairs	樓下的房客
Call of Heros	危城
Weeds on Fire	點五步
FIooing Around Jiang Hu	江湖悲劇
Case II	魕異
At Café 6	六弄咖啡館
Monkey King: Hero is Back	西遊記之大聖歸來
The Moment	我們的那時此刻
A Chinese Odyssey: Part Three	大話西遊3
No where to hide	男極探射燈
Prince	哥基王子
Utopians	同流合烏
the True Love	不愛不散
ZAPP	蘋行世界之程
The Posterist	海報師：阮大勇的插畫藝術
Show me your love	大手牽小手
Drink Drank Drunk	3條友飲醉走
Sky on Fire	沖天火
The Road to Mandalay	再見瓦城
Final Project	玩謝大師
L for Love, L for Lies Too	失戀日
The Map of DNA	他媽²的藏寶圖
A Tale of Three Cities	三城記
Like Life	人生按個讚
David Loman 2	大尾鱸鰻2
Rookie Chef	神廚
Hong Kong Trilogy	香港三部曲
3688	想入飛飛
Love in Vain	獨一無二
Brotherhood of Blades	繡春刀
Welcome To The Happy Days	五星級魚乾女
Lokah Laqi！	只要我長大
Mole of Life	黑白
See You Again	奇幻同學會
White Lies, Black Lies	失控謊言
Monster Hunt	捉妖記
Anniversary	紀念日
8000 Miles from Hip Hop	屌人
Long Long Time Ago 1	我們的故事1
Long Long Time Ago 2	我們的故事2
The Master	師父
The M Riders Finding Pangu	萌學園：尋找磐古
The 17th Journey of Compassion	乘願再來九百年
Go！Crazy Gangster	風雲高手
The Chinese Mayor	大同
Happy Dorm	極樂宿舍
Go Angels Go! Taiwan Bike Holiday	天使去哪兒-台灣單車假期
Ten Years	十年
The Big Power	大顯神威
Yes, Sir!7	報告班長7 無路可退
Ace of Sales	銷售奇姬
My Egg Boy	我的蛋男情人
Battle Of Hip Hopera	終極舞班
After Spring, the Tamaki Family	海的彼端
S Storm	S風暴
Short story at the West Gate	我的西門小故事
Ode to Time	四十年
From Now On	此後
Foret Debussy	德布西森林
Black Sheep	兒子老子
An Odyssey of Dreams	童夢—旅美畫家呂游銘的逐夢旅程
Fight For Justice	進擊之路
Cycling Angels	單車天使
HEBEI TAIPEI	河北臺北
Godspeed	一路順風
Packages from Daddy	心靈時鐘
BETELNUT GIRLS	櫥窗人生
Absent without Leave	不即不離
Life Risking Romance	危險羅曼史
The Flush of Dawn	行者三太子─迎向曙光
Black Bear Forest	黑熊森林
10,000 MILES	一萬公里的約定
The House That Never Dies	京城81號
Goosebumps	怪物遊戲
The Revenant	神鬼獵人
Suffragette	女權之聲：無懼年代
Brooklyn	愛在他鄉
Anomalisa	安諾瑪麗莎
The Wave	驚天巨浪
Dirty Grandpa	阿公歐買尬
The End of the Tour	寂寞公路
Daddy's Home	家有兩個爸
The Dressmaker	惡女訂製服
Extraction	終極救援
Jeruzalem	聖獄:耶路撒冷
We Are Family	我們全家不太熟
45 Years	45年
Son of Saul	索爾之子
Galaxy Turnpike	銀河街道
Midnight Sun	極地奇蹟
The Good Dinosaur	恐龍當家
The Hateful Eight	八惡人
Concussion	震盪效應
Pride and Prejudice and Zombies	傲慢與偏見與殭屍
How to Be Single	單身啪啪啪
Spotlight	驚爆焦點
The Danish Girl	丹麥女孩
Freeheld	扣押幸福
Zoolander 2	名模大間諜2
David Loman2	大尾鱸鰻2
Nina Forever	非普通屍戀
Zootopia	動物方城市
Trumbo	好萊塢的黑名單
The Other Side of the Door	鬼門開
Youth	年輕氣盛
Room	不存在的房間
Marry Me!	假掰新郎
The Boy	託陰
Colonia	窒命地
Mustang	少女離家記
Patema Inverted	帕蒂瑪的顛倒世界
The Lobster	單身動物園
Welcome to Happy Days	五星級魚干女
Macbeth	馬克白
Senior	聞鬼師
The Young Messiah	少年彌賽亞
Life	我們走過叛逆年代
Labyrinth Of Lies	謊言迷宮
Liza, the Fox-Fairy	狐仙麗莎煞煞煞
A Bride for Rip Van Winkle	被遺忘的新娘
Mole Of Life	黑白
The Jungle Book	與森林共舞
10 Cloverfield Lane	科洛弗10號地窖
Criminal	換腦行動
Friend Request	非死不可
Blackway	反擊
Heaven In the Dark	暗色天堂
Embrace of the Serpent	夢遊亞馬遜
Look Who's Back	吸特樂回來了！
The Clan	大犯罪家
My Golden Days	那些年狂熱戀情
The Fencer	擊劍大師
Love	愛
Finding Vivian Maier	尋秘街拍客
The Brand New Testament	死期大公開
99 Homes	居住正義
The Farewell Party	快樂告別的方法
The Inerasable	被詛咒的房間
Valley of Love	愛重逢以後
Stung	蜂狂
Eva Braun	情慾莊園
Neighbors 2	惡鄰纏身2
Money Monster	金錢怪獸
X-Men: Apocalypse	X戰警:
Alice Through the Looking Glass	魔境夢遊2
Equals	禁愛世界
My Big Fat Greek Wedding 2	我媽的希臘婚禮
The Final Lesson	最後一堂課
Doukyuusei	同級生
Hardcore Henry	超狂亨利
Body	通靈診療室
Florence Foster Jenkins	走音天后
Terra Formars	火星異種
All About Them	我愛妳,妳愛她
The Man Who Knew Infinity	天才無限家
Alaska	愛,囚禁
Mr. Right	真愛有夠殺
Rams	羊男的冰島冒險
Book Of Love	北京遇上西雅圖之不二情書
Ever Been to the Moon	麥田書香
Closet Monster	愛人怪物
The Wait	西西里的漫長等待
Spring	魔物戀人
Spy Time	特務超級爸
Teenage Mutant Ninja Turtles 2	忍者龜2:破影而出
The Conjuring 2	厲陰宅2
My Love Story!!	俺物語!!
Me Before You	我就要你好好的
The Handmaiden	下女的誘惑
Nobunaga Concerto: The Movie	信長協奏曲
Now You See Me: The Second Act	出神入化2
A Hologram for the King	梭哈人生
The Paradise Suite	夢碎天堂
Sing Street	搖滾青春戀習曲
Kizumonogatari: I Tekketsu-hen	傷物語: 鉄血篇
Pressure	深海逃脫
The Canal	運河怪談
Swung	春色蕩漾
The Look of Silence	沉默一瞬
Vita Activa: The Spirit of Hannah Arendt	漢娜鄂蘭─思想的行動
Ghostbusters	魔鬼剋星
Star Trek 3	星際爭霸戰3
Bourne 5	神鬼認證5
The Secret Life of Pets	寵物當家
Before I Wake	鬼撕眠
The Purge: Election Year	國定殺戮日3
High Strung	舞力重擊
Creepy	恐怖鄰人
The Diabolical	異次元凶間
The Most Beautiful Day	最酷的一天
Things to Come	愛情未來
This Summer Feeling	夏日情事
UMRIKA	歡迎來到美國
Viva	變裝皇后萬萬歲
Julieta	沉默茱麗葉
Me, Myself and Her	不只是閨蜜
The BFG	吹夢巨人
Ben-Hur	賓漢
Mechanic: Resurrection	極速秒殺2
Neerja	妮嘉
Call Of Heroes	危城
Up for Love	我的哈比情人
Life on the Line	命懸生死線
One Piece Film Gold	航海王電影 Gold
The Neon Demon	霓虹惡魔
The Commune	丹麥共居生活
Saint Amour	醉後之旅
The Wailing	哭聲
Zero Days	零日網路戰
I'm Off Then	我出去一下
Miles Ahead	瘋狂邁爾士
Hedi	推銷員之戀
Bite	變蟲人
Francofonia	攻佔羅浮宮
Correspondence	愛情天文學
Nine Lives	我的老爸喵星人
Bridget Jone's Baby	BJ有喜
Snowden	神鬼駭客:史諾登
Miss Peregrine's Home for Peculiar Children	怪奇孤兒院
Love & Friendship	蘇珊夫人尋婚計
Nerve	玩命直播
Precious Cargo	終極飆靶
Hell Or High Water	赴湯蹈火
Battle Of Hip Hopera	終極舞班
Abattoir	特厲鬼屋
Morgan	魔詭
Take me home	鬼打牆
Where to Invade Next	插旗攻城市
Green Room	納粹龐克
Operation Chromite	代號: 鐵鉻行動
Chevalier	非普通型男
The Magnificent Nine	殿下萬萬稅
A Man Called Ove	明天別再來敲門
Free the Nipple	Lady's 尖頭們
A Tale of Love and Darkness	愛與黑暗的故事
After the Storm	比海還深
Therapy for a Vampire	吸血鬼腥靈診療
Desierto	最後一次自由
Maggie's Plan	NY單身日記
Deeper	性愛巴弒
Haunted Campus	超自然研究會
Yu-Gi-Oh!: The Dark Side of Dimensions	遊戲王:次元的黑暗面
Me and Kaminski	大藝術家與我
Genius	天才柏金斯
Bitter Honey	甜蜜的哀傷
Evergreen Love	植物圖鑑
The Accountant	會計師
Doctor Strange	奇異博士
Deepwater Horizon	地平線
Inferno	地獄
The Together Project	獵愛大臨演
The Model	時尚帝國合約的開始
Midnight at University	鬼才要畢業
The Light Between Oceans	為妳說的謊
Marguerite	巴黎走音天后
Your Name	你的名字
Tomcat	愛是一隻貓
Ants On a Shrimp	神廚東京壯遊記
The Disappointments Room	鬼開門
The Girl on the Train	列車上的女孩
Perfect Strangers	完美陌生人
Do You See Me?	我的型男老闆
Hollars	重返心原點
Anger	怒
American Pastoral	美國心風暴
Miss You Already	已經很想妳
Masterminds	笨賊樂盜家
Trolls	魔髮精靈
Billy Lynn’s Long Halftime walk	比利林恩的中場戰事
Death Note: Light up the NEW world	死亡筆記本:
Free State of Jones	烈火邊境
Museum	惡魔蛙男
Hacksaw Ridge	鋼鐵英雄
A Monster Calls	怪物來敲門
The 9th Life of Louis Drax	路易的第9條命
Shut In	育陰房
Blair Witch	追殺厄夜叢林
Who Gets the Dog?	毛小孩選邊站
Cherry Tree	陰桃術
Public Friends	玩命光頭
The Preppie Connection	玩酷壞痞子
For Grace	獻給米其林的生命貴客
The Age of Shadows	密探
Nocturnal Animals	夜行動物
La La Land	樂來越愛你
Rogue One: A Star Wars Story	星際大戰外傳:俠盜一號
Passengers	靈異航班
Underworld 5	決戰異世界5
Sing	歡樂好聲音
Collateral Beauty	最美的安排
Why Him?	惱爸偏頭痛
Assassin's Creed	刺客教條
Fallen	墮落天使
Tunnel	失控隧道
10,000 Miles	一萬公里的約定
The Ferryman	擺渡人
Incarnate	卡內陰
Nitro Rush	終極車陣: 飆出重圍
A Street Cat Named Bob	遇見街貓BOB
Marina	瑪麗娜之橋
Planetarium	通靈美人
It's Only the End of the World	不過就是世界
Louder Than Bombs	記憶乍響
I, Daniel Blake	我是布萊克
Sadako vs Kayako	貞子 VS 伽椰子
Brave Rabbit 2 Crazy Circus	闖堂兔2：瘋狂馬戲團
Bicycle Boy	龍騎俠
Miss Granny	重返20歲
The Lead Singer and Dancer and His Woman	傘頭和他的女人
Who's the One	找個高富帥
Lotus Code	諜·蓮花
Shanghai Noir	暴走神探
Money Game	黃金福將
Taste of China	味道中國
Déjà vu	我要你開花
Tales of Mystery	怪談
Onion from the boot of a Benz	奔馳的大蔥
Hot Blood Band	熱血男人幫
Online	時光大戰
Running Man	奔跑吧兄弟
Boonie Bears: Mystical Winter	熊出沒之雪嶺熊風
Pleasant Goat and Big Big Wolf– Amazing Pleasant Goat	喜羊羊與灰太狼大電影7：羊年喜羊羊
Sorry, Baby	寶貝，對不起
Legend Of The Moles-The Magic Train Adventure	摩爾莊園大電影3：魔幻列車大冒險
Appassionato sonata	熱情奏鳴曲
One Night Stud	有種你愛我
Crazy New Year's Eve	一路驚喜
The Mystery of Death&#160;: Pisces Jade Pendant	死亡之謎之雙魚玉佩
An Inspector's Calls	神探駕到
The Hero of Color City	蠟筆總動員
Somewhere Only We Know	有一個地方只有我們知道
Be Together	我只要我們在一起
Wolf Totem	狼圖騰
Zhong Kui: Snow Girl and the Dark Crystal	鍾馗伏魔：雪妖魔靈
Dragon Blade	天將雄師
From Vegas to Macau 2	澳門風雲2
Triumph in the Skies	衝上雲霄
Emperor Holidays	爸爸的假期
Dad, Where Are We Going? 2	爸爸去哪兒2大電影
Legend of A Rabbit: The Martial of Fire	兔俠之青黎傳說
Lucky Star 2015	吉星高照2015
Right Mistake	將錯就錯
Flying With Daddy	全能囧爸
The Wonderful Wedding	大囍臨門
Beautiful Stupid Women	美麗笨女人
The Angel: The Prescription for Life	天使：生命處方
Beijing New York	北京紐約
Mother's Dream	母親的夢想
Who moved My Fiancee	海島之戀
Nowhere to run	封門詭影
Lost and Lonely	失孤
Little Big Master	五個小孩的校長
Bright Wedding	璀璨的婚禮
The Seventh Lie	第7謊言
Rookie	菜鳥
10000 Years Later	一萬年以後
Let's Get Married	咱們結婚吧
Wolf Warriors	戰狼
Two Thumbs Up	衝鋒車
Insanity	暴瘋語
Midnight Garage	三更車庫
Outcast	白幽靈傳奇之絕命逃亡
The Invincible Piglet	無敵小飛豬
Kungfu style	特功明星
The Queens	我是女王
Gun Transit	槍過境
No Money no Talk	十萬伙急
Scary Road Is Fun	陌路驚笑
Ever Since We Love	萬物生長
Extremely Urgent	迫在眉睫
The Left Ear	左耳
Red Amnesia	闖入者
Murmur of the Hearts	念念
Loves &amp; Movies	愛我就陪我看電影
Helios	赤道
You Are My Sunshine	何以笙簫默
Teenage Mao Zedong	少年毛澤東
Love of Gulu	姑魯之戀
Follow Me,My Queen	女神跟我走
War on a String	懸戰
Relationship Dilemma	分手不分手
The light	永遠的守望
Mr. Deng Goes to Washington	旋風九日
The Beloved	重生愛人
12 Citizens	十二公民
Love Without Distance	土豪520
Unforgettable Blast	迷與狂
Feed Me	哺乳期的女人
Alibaba and The Thief<	阿里巴巴：大盜奇兵
Wonder Mama	媽咪俠
Unmissable	不能錯過
Dawn Break Up	天亮·分手
The Grow 2	金箍棒傳奇2
Happy Little Submarine Magic Box of Time	潛艇總動員：時光寶盒
The Horizon of The Child	天邊的孩子
Rabbit Hero	超能兔戰隊
Monsters	異獸禁區
Lost in Wrestling	搏擊奇緣
Free Ride	順風車
Who Am I 2015	我是誰2015
Gone With the Time	再見我們的十年
SPL 2	殺破狼2
The Art of Mr.Chow	少年班
One Minute More	我的男友和狗
Admission by Guts	驚魂電影院
Rock Hero	搖滾英雄
Wo Shi Xiang Xia Ye	我是鄉下爺
The Temptation in Lincang	臨滄的誘惑
Come Back, Love	約定倒計時
My Geeky Nerdy Buddies	大宅們
We Will Make It Right	因為谷桂花
Twilight Online	恐怖在線
Hear Me	聽說
Where the Wind Settles	風中家族
Cannot Prove	無法證明
I Love You, Too	戀愛排班表
Hollywood Adventures	橫衝直撞好萊塢
The Adventures of Little Piglet Banna	小豬班納之夢想大帽險
The Three Pigs and The Lamp	三隻小豬與神燈
Silently Love	默守那份情
Monk Comes Down the Mountain	道士下山
Love Simply	簡單愛
Chang Chen Ghost Storie	張震講故事之鬼迷心竅
I Am Somebody	我是路人甲
Xi You Xin Zhuan2 ：hen Xin Hua Da Mao Xian	西遊新傳2：真心話大冒險
The Autobots	汽車人總動員
Tiny Times 4.0	小時代：靈魂盡頭
Fight it&#160;! Youth	奮鬥吧！青春
Forever Young	怒放之青春再見
Dear, don’t be Afraid	親，別怕
CUG: King of Heroes	西遊記之大聖歸來
GG Bond Movie:Ultimate Battle	豬豬俠之終極決戰
Nezha<	少女哪吒
Jian Bing Man	煎餅俠
Magic Barber	愛情魔發師
Aura star: attack of the temple	奧拉星：進擊聖殿
Seer 5	賽爾號大電影5：雷神索爾崛起
Psychic	通靈之六世古宅
Only You	非你勿擾
Dream Defender	守夢者
Love Will Be Back	等愛歸來
Wild City	迷城
Lady of the Dynasty	王朝的女人·楊貴妃
The Crossing	太平輪：驚濤摯愛
Who in the Pool	恐怖游泳館
Paris Holidays	巴黎假期
The making of a man	男人製造
The Little Mermaid: Attack of The Pirates	美人魚之海盜來襲
Black Pupil	黑瞳
Sword of Hope	軒轅劍傳奇
Love in the Office	一路向前
Kwai Boo	桂寶大電影之爆笑闖宇宙
To The Fore	破風
The Buried Secrets	紅髏
Legend of Didao	小西天狄道傳奇
Time To Love	新步步驚心
Love, At First	愛之初體驗
The Best Love	我爸比我小四歲
The Spirit of the Swords	情劍
Where Are All The Time	時間都去哪了
Mr Black&#160;: Green Star	黑貓警長之翡翠之星
Go away Mr. Tumour	滾蛋吧！Mr. Tumor
Detective Gui	宅女偵探桂香
Roco Kingdom 4	洛克王國4：出發！巨人谷
A Promise to the Kurichenko's	相伴庫里申科
Snow White: The Mysterious Father	白雪公主之神秘爸爸
Mid-July Days	七月半之恐怖宿舍
Panda Hero Legend	我是大熊貓之熊貓大俠
Bride Wars	新娘大作戰
Cities In Love	戀愛中的城市
Ballet in the Flames of War	戰火中的芭蕾
Twin Spirit	雙生靈
Entrapment	誘狼
The Assassin	刺客聶隱娘
The Dead End	烈日灼心
Wild Desert	心跳戈壁
Tale of Three Cities	三城記
A Jewish Girl in Shanghai: The Mystery of the Necklace	猶太女孩在上海2：項鍊密碼
Doomed Disaster	詭劫
Fighting Youth	我是奮青
The Hundred Regiments Offensive	百團大戰
Upheaval of Jiawu	大變局之夢回甲午
Honey Enemy	情敵蜜月
The Old Cinderella 2	男神時代
Office	華麗上班族
The Road	窮途
Cairo Declaration	開羅宣言
Atrange Bedfellows	枕邊詭影
Enchanted Mirror Romance	魔鏡奇緣
The Young Yang Jingyu	少年楊靖宇
All You Need is Love	落跑吧愛情
The Age of Innocence	純真年代
The Calligraphy Master	啟功
Love in the 1980s	1980年代的愛情
A Dongguan Girl	東莞女孩
Fly Me to Venus	星語心愿之再愛
Ulterior Motive	別有動機
Behind Bayonets and Barbed Wire	鐵血殘陽
S for sex S for secret	小姐誘心
The Puzzle of Human Skin	人皮拼圖
Tomb Mystery	墓穴迷城
Lost In Hong Kong	港囧
Second Chance	逆轉勝
Gui Da Qiang	詭打牆
The Mirror	魔鏡
The Third Way of Love	第三種愛情
CJ7: Super Q Team	長江7號：超萌特攻隊
Saving Mr. Wu	解救吾先生
Chronicles of the Ghostly Tribe	九層妖塔
Balala The Fairies-Princess Camellia	巴啦啦小魔仙之魔箭公主
Mom, Let Me Love You Once Again	媽媽，讓我再愛你一次
A Tale From The Orient	天眼傳奇
Polar Adventure	極地大反攻
Eternal Promise of Love	天各一方
A Tiger Wife	家有虎妻
Deep in the Heart	心迷宮
Magic Card	魔卡行動
The Dangerous Affair	零點殺機
Campus Mystery	筆仙魔咒
Himalaya: Ladder to Paradise	喜馬拉雅天梯
Morengen Bear vs Man	莫日根
Where‘s the dragon？	龍在哪裡？
River Road	家在水草豐茂的地方
Youth Never Returns	既然青春留不住
Blind Spot	探靈檔案
Undercover Duet	猛龍特囧
Romance Out Of The Blue	浪漫天降
The Promised Land	回到被愛的每一天
Happiness Is Very Embarrassing	幸福很囧
Mountains May Depart	山河故人
First of May	十七歲
The Witness	我是證人
Midnight Whisper	半夜叫你別回頭
Age of Glory	鋼鐵，是這樣煉成的
Hapless Thief	囧賊
The Firefox of Bunnington Burrows	兔子鎮的火狐狸
The Verse of Us	我的詩篇
My Virgin Land	我的處女地
The White Lie	火雲端
Midnight Ghosts	雨夜驚魂
Fight Up	激戰黎明
A Time of Beauty	時尚女郎之女人江湖
My Original Dream	我的青春期
A Journey, through Time, with Anthony	陪安東尼度過漫長歲月
This Is Me	年少輕狂
Grudge pix	恐怖照相機
One Times	我的少女時代
A Fool	一個勺子
Return of the Cuckoo	十月初五的月光
Chasing Hemingway	遭遇海明威
The King of Tibetan Antelope	藏羚王之雪域精靈
Chinese Horrostory	靈臆事件
Lovely Devil	痞子·洛克
Dream Come Ture	一刻十年
Bad Guys Always Die	壞蛋必須死
Fruit Rockers	搖滾水果
The Murderer Vanishes	消失的兇手
Deception Obsession	詭影迷情
Fall In Love Like A Star	怦然星動
Oh My God	從天兒降
Go Lala Go 2	杜拉拉追婚記
Impossible	不可思異
War of Surrender	受降前夕
I am big star	我是大明星
Dream Holiday	夢幻佳期
An Accidental Shot or Love	擦槍走火
North by Northeast	東北偏北
E-commerce Times	電商時代
The Spring Of My Life	最美的時候遇見你
Forever Love	阿嬤的夢中情人
Full Strike	全力扣殺
The Winner	聖誕大贏家
Gulu Mermaid	咕嚕咕嚕美人魚
Love Detective	沒女神探
Surprise	萬萬沒想到：西遊篇
The Doll	詭娃娃
Fading Wave	老炮兒
Devil and Angel	惡棍天使
Youth is A War	青春一戰
Heart for Heaven	一念天堂
Massagist	索命暹羅之按摩師
The Prospector	探秘者
Women Who Flirt	撒嬌女人最好命
Dearest	春花秋月不了情
The Gigolo	鴨王
Gone with the Bullets	一步之遙
The Trump Card	誰是臥底之王牌
Partners In Crime	共犯
From Vegas to Macau II	賭城風雲II
Blind Massage	推拿
Exit	迴光奏鳴曲
An Inspector Calls	浮華宴
12 Golden Ducks	12金鴨
Sara	雛妓
Lucky STAR 2015	吉星高照2015
Zhong Kui: Snow Girl and The Dark Crystal	鍾馗伏魔：雪妖魔靈
Guilty	四非
Fleet Of Time	匆匆那年
One Night in Taipei	台北夜遊團團轉
Beautiful 2015	美好2015
The Unbearable Lightness of Inspector Fan	暴走神探
Where Are We Going, Dad? 2)	爸爸去哪兒2
Angel Whispers	花街柳巷
(Wolf Warriors	戰狼
The Taking of Tiger Mountain	智取威虎山
King Of Mahjong	麻雀王
Imprisoned&#160;: Surival Guide For Rich And Prodigal	媽寶蹲監日記
Wonder MaMa	媽咪俠
Sand Pebbles	大浪淘沙
Flowers Of Taipei - Taiwan New Cinema	光陰的故事－台灣新電影
When Geek Meets Serial Killer	宅男女神殺人狂
Hill of Ilha Verde	青洲山上
Knock Knock Who's There?	有客到
Guia In Love	燈塔下的戀人
The Merger	我們停戰吧
Get Outta Here	死開啲啦
Super Models	色模
Lazy Hazy Crazy	同班同學
Are You Here	碟仙碟仙
TV Z	TV屍
Big Fortune Hotel	吉祥酒店
Mountains May Depart)	山河故人
Fly me to Venus	星語心願之再愛
Zinnia Flower	百日告別
Lost in Hong Kong	港囧
Daughter	上身
Keeper of Darkness	陀地大法師
Port of Call	踏血尋梅
The Vanished Murderer	消失的兇手
Go Lala Go	追婚日記
The Gathering	同學會
Time is Money	十萬夥急
Taipei Factory 2	台北工廠II
Kara-Orchestra	很久沒有敬我了妳
Don't go breaking my Heart 2	單身男女2
Black Coal, Thin Ice	白日焰火
The Arti&#160;: The Adventure Begins	奇人密碼－古羅布之謎
Golden Age	黃金時代
Lion Dancing 2	鐵獅玉玲瓏2
Drgaon Blade	天將雄師
Su Beng, the Revolutionist	史明·革命進行式
My Mr.right	我的Mr. Right
Little Knights	小騎士闖通關之美夢成真
Little Big Panda	熊貓總動員
The walkers	行者
Sashimi	沙西米
First Of May	五月一號
Baby Steps	滿月酒
The Missing Piece	缺角一族
The Search For General Tso	尋找左宗棠
Elena	愛琳娜
Battle Up!	舞鬥
What Makes Love Last	長情的告白
Thanatos, Drunk	醉·生夢死
Our Times	我的少女時代
The Crossing Ⅱ	太平輪：驚濤摯愛
Song of the Reed	蘆葦之歌
The Bride	屍憶
The Laundryman	青田街一號
OPEN！ OPEN！	OPEN！ OPEN！
Ways Into Love	來得及說再見
Dream Ocean	夢想海洋
Attabu II	阿罩霧風雲─落子
Riding The Breeze	南風
Time to Love	新步步驚心
Trapped at Sea, Lost in Time	海上情書
One Journey, One Mission	有任務的旅行
When Miracle Meets Maths	愛情算不算
Maverick	菜鳥
RailWay	鐵支路
Fly, Kite Fly	老鷹想飛
Meet Miss Anxiety	我的早更女友
Taste of Life	百味人生
The Rocking Sky	沖天
The Woman in Black: Angel of Death	顫慄黑影2：死亡天使
Taken 3	即刻救援3
Selma	逐夢大道
Predestination	超時空攔截
The Wedding Ringer	伴郎友沒友
Blackhat	黑帽駭客
Spare Parts	夢想啟動
Ex Machina	機械姬
The Boy Next Door	隔壁的男孩殺過來
Strange Magic	仲夏夜魔法
Mortdecai	神鬼大盜
Song One	紐約安可曲
Wild Card	拳力突襲
The SpongeBob Movie: Sponge Out of Water	海綿寶寶：海陸大出擊
Jupiter Ascending	朱比特崛起
Seventh Son	第七傳人
Fifty Shades of Grey	格雷的五十道陰影
Kingsman: The Secret Service	金牌特務
McFarland, USA	夢想越野隊
The DUFF	恐龍尤物
Hot Tub Time Machine 2	扭轉時光機2
Focus	決勝焦點
The Lazarus Effect	永夜魔女
A la mala	一個壞女孩
Chappie	成人世界
The Second Best Exotic Marigold Hotel	金盞花大酒店2
Unfinished Business	凸槌三人行
Kidnapping Mr. Heineken	綁架海尼根
Cinderella	仙履奇緣
Run All Night	一夜狂奔
Suite Française	亂世有情天
The Divergent Series: Insurgent	分歧者2：叛亂者
The Gunman	全面逃殺
Do You Believe?	你相信嗎
Danny Collins	翻唱人生
Home	好家在一起
Get Hard	獄前教育
Woman in Gold	名畫的控訴
Furious 7	玩命關頭7
Beyond the Mask	面具之上
The Longest Ride	愛情沒有終點
Clouds of Sils Maria	星光雲寂
Paul Blart: Mall Cop 2	百貨戰警2
Unfriended	弒訊
Monkey Kingdom	猴王國
True Story	真實的故事
Child 44	失控獵殺：第44個孩子
The Age of Adaline	時空永恆的愛戀
Little Boy	小男孩
The Water Diviner	伊斯坦堡救援
Avengers: Age of Ultron	復仇者聯盟2：奧創紀元
Far from the Madding Crowd	遠離塵囂：珍愛相隨
Hot Pursuit	辣味雙拼
The D Train	糟糕的兄弟情
Maggie	我的殭屍女兒
Spooks: The Greater Good	軍情五處：利益之爭
Pitch Perfect 2	歌喉讚2
Mad Max: Fury Road	瘋狂麥斯：憤怒道
Slow West	西部緩慢之死
I'll See You in My Dreams	我們夢中見
Tomorrowland	明日世界
Poltergeist	鬼哭神嚎 惡靈15
The Human Centipede 3	人形蜈蚣3
San Andreas	加州大地震
Aloha	飛越情海
Man Up	冒牌情緣
Entourage	2015 大明星小跟班
Spy	麻辣賤諜
Insidious: Chapter 3	陰兒房第3章：從靈開始
Love &amp; Mercy	搖滾愛重生
Jurassic World	侏羅紀世界
Me and Earl and the Dying Girl	我們的故事未完待續
Inside Out	腦筋急轉彎
Dope	嘻哈宅男真藥命
Advantageous	2Q41：茱兒的禮物
Ted 2	熊麻吉2
Max	海軍忠犬馬克斯
Terminator Genisys	魔鬼終結者：創世契機
Magic Mike XXL	舞力麥克：尺度極限XXL
Minions	小小兵
The Gallows	絞刑台
Self less	換命法則
Tangerine	夜晚還年輕
Amy	艾美懷絲
Ant-Man	蟻人
Trainwreck	姐姐愛最大
Mr. Holmes	福爾摩斯先生
Smosh: The Movie	神馬氏電影版
Pixels	世界大對戰
Southpaw	震撼擂台
Paper Towns	紙上城市
Phoenix	回不去的時光
Vacation	全家玩到趴
Mission Impossible – Rogue Nation	不可能的任務：失控國度
Shaun the Sheep Movie	笑笑羊大電影
Fantastic Four	驚奇4超人
The Gift	非禮勿弒
Ricky and the Flash	搖滾女王
Dark Places	暗處
Straight Outta Compton	衝出康普頓
The Man from U.N.C.L.E.	紳士密令
Sinister 2	凶兆2：雙瘋
Hitman: Agent 47	刺客任務：殺手47
American Ultra	廢柴特務
No Escape	無處可逃
War Room	戰爭房間
We Are Your Friends	音浪青春
Z for Zachariah	末日寂境
The Transporter Refueled	玩命快遞：肆意橫行
Before We Go	紐約愛未眠
The Perfect Guy	完美傢伙
The Visit	探訪
90 Minutes in Heaven	在天堂90分鐘
Sleeping with Other People	愛睡在一起
Pawn Sacrifice	出棋制勝
Maze Runner: The Scorch Trials	移動迷宮：焦土試煉
Black Mass	黑勢力
Sicario	怒火邊界
Everest	聖母峰
Captive	隨機人質
Steve Jobs	史帝夫賈伯斯
Hotel Transylvania 2	尖叫旅社2
The Intern	高年級實習生
Stonewall	石牆風暴
The Walk	走鋼索的人
The Martian	絕地救援
Hell and Back	地獄之旅
Pan	潘恩：航向夢幻島
Knock Knock	當辣妹來敲門
The Final Girls	驚叫少女
Bridge of Spies	間諜橋
Crimson Peak	腥紅山莊
Woodlawn	橄欖球傳奇
Truth	真相急先鋒
Beasts of No Nation	無境之獸
The Last Witch Hunter	獵巫行動：大滅絕
Paranormal Activity: The Ghost Dimension	鬼入鏡5
Rock the Kasbah	沙漠飆高音
Jem and the Holograms	芙蓉仙子
Our Brand Is Crisis	危機女王
Burnt	天菜大廚
Scouts Guide to the Zombie Apocalypse	殭屍教戰守則
Spectre	007：惡魔四伏
The Peanuts Movie	史努比
Love the Coopers	庫柏一家
By the Sea	海邊
The Hunger Games: Mockingjay - Part 2	飢餓遊戲：自由幻夢 終結戰
The Night Before	聖誕前夜
Secret in Their Eyes	沉默的雙眼
Legend	金牌黑幫
Carol	因為愛你
Creed	金牌拳手
Victor Frankenstein	怪物
Krampus	聖誕妖怪：坎卜斯
In the Heart of the Sea	白鯨傳奇：怒海之心
The Big Short	大賣空
Star Wars: The Force Awakens	星際大戰七部曲：原力覺醒
Alvin and the Chipmunks: The Road Chip	鼠來寶：鼠喉大作讚
Sisters	瞎趴姊妹
Joy	翻轉幸福
Point Break	飆風特攻
Future Fighters	守兵衛
Sorry I Love You	對不起，我愛你
As The Light Goes Out	無路可退
Perfect Beyond	完美超越
Once Upon A Time In Shanghai	惡戰
Bitter Love	哭戀
The True Love	不愛不散
Good Morning, Winter Sea	早安，冬日海
Hello Babies	六福喜事
Meet The Pegasus	喜羊羊與灰太狼之飛馬奇遇記
Da Han Tao Hua Kai	大寒桃花開
The Apostles	詭鎮
Xiong Chu Mo	熊出沒之奪寶熊兵
Dendrobium	石斛蘭
A Gold Medal Winning Tramp Dog	金牌流浪狗
Balala The Fairies-The Magic Trial	巴啦啦小魔仙之魔法的考驗
Everlasting Broadcasting	永不消失的廣播
The Monkey King	西遊記之大鬧天宮
Ex File	前任攻略
Dad, Where Are We	爸爸去哪兒
The Man From Macau	澳門風雲
Just Another Margin	大話天仙
Beijing Love Story	北京愛情故事
Unexpected Love	誰說我們不會愛
Bends	過界
The Lodge In The Woods	林中小屋
The Destiny	江南愛情故事
Love Needs One More Night	一見未鍾情
Chrysanthemums Terrace	菊花台
People Searching Story of Cola Lee	李可樂尋人記
Shining Soul	閃魂
The Struggle Of 80's	80後的獨立宣言
General's Goblet	奪樽
Final battle in Chengzigou of kongfu saga	武僧傳奇之決戰程子溝
Lock Me Up,Tie Him Down	完美假妻168
Pretty Maid	一個溫州的女人
You Are The One	戀者多喜歡
The Old Cinderella	脫軌時代
Sweet Alibis	甜蜜殺機
The Land Is So Rich in Beauty	蘭亭 (電影)
The Extreme Fox	非狐外傳
Limi Girl	俐侎阿朵
Hua Zhuang Shi	化妝師
The Police Diary	警察日記
Fighting	一號目標
Horse Trader	盜馬記
On The Way	我在路上最愛你
Let go for love	幸福中轉站
The Truth About Beauty	整容日記
Death is Here 3	筆仙驚魂3
Super Three	三小強
Huang Haihuai	黃海懷
Ameera	特工艾米拉
Long's Story	硬漢奶爸
Good Love Again	再愛一次好不好
Love And Hate From Cyber	誰偷了我的菜
Delete My Love	Delete愛人
Xue Cai	血彩
Phurbu & Tenzin	西藏天空
Campus Confidential	愛情無全順
Turandot	圖蘭朵
That Demon Within	魔警
The Suspicious	最佳嫌疑人
Stealing Legend	國寶疑雲
Eternal Love	201413愛你一世一生
My Ol' Classmate	同桌的你
Iceman 3D	3D冰封俠：重生之門
The Great Hypnotist	催眠大師
Let Go For Love	放手愛
Enchanted Doll	怖偶
Aberdeen	香港仔
Forbidden Kiss	古堡之吻
Deslie for Young	渴望的青春
Mysterious Bullet	近距離擊殺
Revolution Places Manufacture	邊區造
The Cross-generational Dairies	僑女日記
Genuine Love	真愛
Coming Home	歸來
Urban Games	城市遊戲
To Love Somebody	求愛嫁期
Love at First Sight	第一眼愛情
Broadcasting Girl	我的播音系女友
Happy Dream	幸福夢想
Xin Zhou	心咒
Who is Undercover	一號目標
Impetuous Love in Action	緣來是遊戲
Closed Doors Village	封門村
Mr. Charming	醜男大翻身
Overheard 3	竊聽風雲3：土豪爭霸
The Adventures of Sinbad 2014	辛巴達歷險記2
New Minesweepers Warfare&#160;: Courageous boy	新地雷戰：神勇小子
Magic Wonderland	魔幻仙蹤
Happy Little Submarines 4&#160;: Adventure of Octopus	潛艇總動員4：章魚奇遇記
Space Panda 2	太空熊貓總動員
GG Bond 2	豬豬俠之勇闖巨人島
Qing Di Zhi Ai	情笛之愛
Night of Adventure	瘋狂72小時
Breaking The Waves	激浪青春
The Break-Up Artist	分手達人
Midnight Hair	夜半梳頭
Dream at the Age Of 86	金色時光
Night Mail	死亡郵件
Face Hunter	虐面人之死靈面膜
My Undercover Husband	我的老公是臥底
The Breakup Guru	分手大師
Poseidon Code	海神密碼
Bunshinsaba 3	筆仙III
A Simple Hero	超萌英雄
The Predictor Paul	章魚哥
Old Boy：The Way of The Dragan	老男孩猛龍過江
Seer V	賽爾號大電影4：聖魔之戰
Roco Kingdom 3<	洛克王國3：聖龍的守護
Caught in trap	破局
Tiny Times 3.0	小時代：刺金時代
Happy Heroes 2 Qiyuan Planet Wars	開心超人2：啟源星之戰
Continent	後會無期
The Magical Brush	神筆馬良
No Zuo No Die	我就是我
Girls	閨密
Dragon Nest: Warriors' Dawn	龍之谷：破曉奇兵
The White Haired Witch of Lunar Kingdom	白髮魔女傳之明月天國
Are You Ready to Marry Me	我想結婚的時候你在哪
Break Up 100	不再說分手
Shi Laihe Son of Earth	大地赤子史來賀
Die Xian Gui Tan	碟仙詭譚
All About Puberty	純純欲動
When a Peking Family Meets Aupair	洋妞到我家
The Legend of Qin	秦時明月大電影之龍騰萬里
Yugo&Lala 2	神秘世界歷險記2
Over the Sky	飛躍地心
Gone With Far	江湖論賤實錄
Love Evolutionism	愛情進化特區論
Mr.Lucky	好命先生
Scent	香氣
The Scroll of Wing Chun White Crane	永春白鶴拳之擎天畫卷
Meeting the Giant	再見巨人
Z Storm	Z風暴
Temporary Family	失戀急讓
Snow White The Power of Dwarfs	白雪公主之矮人力量
The Four 3	四大名捕大結局
Fall in Love With You	這個大叔不太囧
Next Station I Love You	下一站再愛你
Under The Bed 2	床下有人2
Fragrance of Flowers	花香
Turn Around	美人邦
Forgetting to know you	忘了去懂你
The Buddha's Shadow	神通佛影
Live With A Thief	與賊同屋
Youth.com	青春.com
The Summer of Our Graduation	我們畢業的夏天
But Always	一生一世
Once Upon a Time in the Old Bridge	大峰祖師
Mo Deng Sen Lin Zhi Mei Shi Zong Dong Yuan	摩登森林之美食總動員
Tale of The Rally	龜兔再跑
The Rebirth of a Flourishing City	孕城
One Day	有一天
King Tea Storm	鬥茶
You Are My Sassy Girl	我是你的野蠻女友
Zero Point Five Love	0.5的愛情
Inside the Girls	女生宿舍
Mountain Ava	森林孤影
Ashes To Ashes	從哪來，到哪去
The Eyes of Dawn	黎明之眼
One Step Away	觸不可及
The Deathday Party	死亡派對
The Eighth House	詭八樓
Hui Lan	蘭輝
Secret Plans	新大頭兒子和小頭爸爸之秘密計劃
Breakup Buddie	心花路放
Farm House II	81號農場之瘋狂的麥咭
The Lost 15 Boys: The Big Adventure on Pirates' Island	喵星少年漂流記
McDull · Me & My Mum	麥兜．我和我媽媽
Black & White:The Dawn of Justice	痞子英雄：黎明再起
Armor Hero Atlas	鎧甲勇士之雅塔萊斯
Shi Er Sheng Xiao Cheng Shi Ying Xiong	十二生肖城市英雄
Bugs	食人蟲
Young Friend Forever	我的青春蜜友
A Motor Home Adventure	房車奇遇
Promise	深情約定
Café·Waiting·Love	等一個人咖啡
South of the Clouds	北回歸線
Double Exposure	詭替身
Town of the Dragon	臥龍崗
The Break-up Season	畢業那年：分手季
Blue Sky Bones	藍色骨頭
Five Minutes to Tomorrow	深夜前的五分鐘
Sex Appeal	寒蟬效應
Target	狙擊時刻
Hero of the River	劍河
The Haunted Cinema	恐怖電影院
The Nightingale	夜鶯
Last Of The Best	一個人的武林
Lonely Island	孤島
Sweet World	鳳凰台
The Boundary	全城通緝
For Love or Money	露水紅顏
She and She	黑月
Gangster Payday	潛龍風雲
The Best Plan Is No Plan	溝女不離三兄弟
Haunted Road	怨靈
Mystery	浮城謎事
The Galaxy On Earth	天河
We Are Young	街舞小子
Rish of the Legend	黃飛鴻之英雄有夢
Destiny of Love	換愛七日
Deng Ni Zhui Wo	等你追我
Fijil Love	斐濟99℃愛情
Tender Woman	撒嬌女人最好命
Bad Sister	壞姐姐之拆婚聯盟
Crazy Love	愛情狂想曲
Young Time	青春時光
I Am Not A Thief	我不是賊
The Crossing Part 1	太平輪：亂世浮生
A Murder Besides YanHe River	黃克功案件
Tomb Robber	密道追蹤之陰兵虎符
Fleet of Time	匆匆那年
Kung Fu Angels	精武青春
Who Moved My Dream	誰動了我的夢想
Flower's Curse	花咒
Coincidence	凡人煩惱
Love on the Cloud	微愛之漸入佳境
Forget All Remember	37次想你
Cherish in Love	愛你不等來生
Golden Brothers	男人唔可以窮
Death Trip	還魂之迷失曼谷
1924 Mao Zhedong in Shanghai 1924	毛澤東在上海·1924
Bloody Doll	怨靈人偶
Sunflowers in full bloom	向陽花開
One Hundred Thousand Bad Jokes	十萬個冷笑話
Lan Kwai Fong 3	喜愛夜蒲3
A Complicated Story	一個複雜故事
Control	控制
Police Story 2013	警察故事2013
Personal Tailor	私人訂製
Mortician	臨終囧事
Golden Chicken S	金雞SSS
From Vegas to Macau	賭城風雲
Pleasant Goat and Big Big Wolf 6	喜羊羊與灰太狼6之飛馬奇遇記
The Skeleton Road	怪談電影：屍骸之路
For Love, We Can	愛不難
Wrath of Vajra	金剛王：死亡救贖
Up In The Wind	等風來
Black Comedy	黑色喜劇
KANO	KANO
Naked Ambition 2	豪情3D
Twelve Nights	十二夜
Lessons in Dissent Movie	未夠秤
The Midnight After	那夜凌晨，我坐上了旺角開往大埔的紅van
Enthralled	愛．尋．迷
Lock Me Up Tie Him Down	完美假妻168
No Man Land	無人區
The Second Coming	重生
N+N	N+N
Soul	失魂
The Ghost Festival	盂蘭神功
Beyond Beauty - TAIWAN FROM ABOVE	看見台灣
A Minute More	只要一分鐘
Breakup 100	分手100次
My Old Classmate	同桌的妳
Flirting In The Air	唐伯虎衝上雲霄
Paradise in Service	軍中樂園
My Voice My Life	爭氣
Sifu VS Vampire	天師鬥殭屍
Zombie Fight Club	屍城
Dot 2 Dot	點對點
Breakup Buddies	心花路放
Gangster Pay Day	大茶飯
Grey Met Shrek	奇緣灰姑娘
Meeting Dr. Sun	行動代號：孫中山
Rise Of The Legend	黃飛鴻之英雄有夢
Revelation of Ghost Marriage	冥婚啟示
I Sell Love	販賣愛
Five minutes to tomorrow	深夜前的五分鐘
The Cartel War	掃毒
A Rolling Stone	築巢人
Battle Spirit	戰酒
My Mandala	原來你還在
Lion Dancing	鐵獅玉玲瓏
TWA-TIU-TIANN	大稻埕
Stray Dogs	郊遊
A Touch of Sin	天註定
A Wedding Invitation	分手合約
The Boar King	山豬溫泉
KIASU	做你愛做的事
The Rice Bomber	白米炸彈客
Naked Ambition	豪情3D
THE PALACE	宮鎖沉香
Mazu Procession	媽祖迺台灣
SO YOUNG	致我們終將逝去的青春
Seer Movie 3	賽爾號大電影3戰神聯盟
The Losers	敗者為王
Anywhere，Somewhere，Nowhere	到不了的地方
Iceman	急凍行者（上卷）
Peace in Love	愛在墾丁─痞子遇到愛
Today and Tomorrow	今天明天
The Journey	一路有你
The Palace on the Sea	海上皇宮
Ice Poison	冰毒
As time goes by in Shanghai	上海老爵士
The Shining Candle	一江明燭
The Frog Ville	桃蛙源記
Dream Flight	想飛
Live a Love	活路：妒忌私家偵探社
Pusu Qhuni	餘生—賽德克·巴萊
Kung Fu Jungle	一個人的武林
It Takes Two to Tango	車拼
Conspiracy	時下暴力
The Chef The Actor The Scoundrel	廚子戲子痞子
Lover Run	男生女生騙
7 Love Design	相愛的七種設計
Endless Nights In Aurora	極光之愛
Paranormal Activity: The Marked Ones	鬼入鏡：詛咒
Yves Saint Laurent	時尚大師聖羅蘭
The Legend of Hercules	鋼鐵力士
The Nut Job	堅果行動
Ride Along	一路前行
Jack Ryan: Shadow Recruit	傑克萊恩︰詭影任務
Devil's Due	惡靈嬰弒
Frank	法蘭克
Freezer	冰人啟示錄
Alive Inside	如夢幻音：沈睡的記憶
I, Frankenstein	科學怪人：屠魔大戰
That Awkward Moment	約會進行時
The Lego Movie	樂高玩電影
The Monuments Men	大尋寶家
Vampire Academy	吸血鬼學院
RoboCop	機器戰警
About Last Night	誘惑·夜風流
Endless Love	愛你一生一世
Winter's Tale	冬季奇蹟
3 Days to Kill	特務殺很大
Pompeii	龐貝
Barefoot	赤足天使
Non-Stop	空中救援
Son of God	上帝之子
300: Rise of an Empire	300壯士：帝國崛起
Mr. Peabody & Sherman	皮巴弟先生與薛曼的時光冒險
The Grand Budapest Hotel	歡迎來到布達佩斯大飯店
Honeymoon	血色蜜月
Need for Speed	極速快感
The Single Moms Club	單身媽媽俱樂部
Veronica Mars	偵探小天后
Better Living Through Chemistry	毒醉心迷
Rob the Mob	搶劫暴徒
Divergent	分歧者
Muppets Most Wanted	布偶歷險記：全面追緝
God's Not Dead	上帝未死
Noah	挪亞方舟
Sabotage	震撼殺戮
The Raid 2: Berandal	全面突襲2：拳力進擊
Ned Rifle	追殺大笨蛋
Captain America: The Winter Soldier	美國隊長2：酷寒戰士
The Quiet Ones	靈異檔案
Rio 2	里約大冒險2
Draft Day	超級選秀日
Heaven Is for Real	真的有天堂
Transcendence	超越那一天
A Haunted House 2	鬼屋電影2
Bears	熊世界
The Other Woman	婦仇者聯盟
Brick mansions	玩命特區
Welcome to Me	歡迎來到我的世界
The Amazing Spider-Man 2	蜘蛛人驚奇再起2：電光之戰
Walk of Shame	姐姐我醉大
Neighbors	惡鄰纏身
Moms' Night Out	老媽之夜
Chef	五星主廚快餐車
Godzilla	哥吉拉
Million Dollar Arm	百萬金臂
Wild Tales	生命中最抓狂的小事
X-Men: Days of Future Past	X戰警：未來昔日
Blended	當我們混在一起
The Angriest Man in Brooklyn	布魯克林最憤怒的人
Maleficent	黑魔女：沉睡魔咒
A Million Ways to Die in the West	百萬種硬的方式
Love & Mercy	搖滾愛重生
The Fault in Our Stars	生命中的美好缺憾
Edge of Tomorrow	明日邊界
Obvious Child	只是個孩子
22 Jump Street	龍虎少年隊：童顏巨捕
How to Train Your Dragon 2	馴龍高手2
Hellion	刺頭青
The Signal	詭異訊
Think Like a Man Too	男人行不行2
Jersey Boys	紐澤西男孩
The Rover	絕命正義
Transformers: Age of Extinction	變形金剛4：絕跡重生
Tammy	譚美
Deliver Us from Evil	惡魔刑事錄
Earth to Echo	地球迴聲
Dawn of the Planet of the Apes	猩球崛起：黎明的進擊
Boyhood	年少時代
The Purge: Anarchy	國定殺戮日：無法無天
Planes: Fire & Rescue	飛機總動員：打火英雄
Sex Tape	愛愛上雲端
Wish I Was Here	B咖的幸福劇本
Persecuted	迫害
I Origins	I型起源
Lucy	露西
Hercules	海克力士
And So It Goes	如此這般
Magic in the Moonlight	魔幻月光
The Fluffy Movie	蓬鬆哥脫口秀
Guardians of the Galaxy	星際異攻隊
Get on Up	激樂人心
Teenage Mutant Ninja Turtles	忍者龜：變種世代
Into the Storm	直闖暴風圈
The Hundred-Foot Journey	美味不設限
Step Up: All In	舞力全開5 3D
Let's Be Cops	冒牌條子
The Expendables 3	浴血任務3
The Giver	記憶傳承人：極樂謊言
If I Stay	如果我留下
When the Game Stands Tall	攻無不克
Sin City: A Dame to Kill For	萬惡城市：紅顏奪命
Love Is Strange	愛，不散
The One I Love	愛的就是你
The November Man	特務交鋒
The Two Faces of January	蜜月殺機
As above so below	忐忑
The Identical	雙生
No Good Deed	危險行為
Dolphin Tale 2	溫特的故事：泳不放棄2
The Drop	錢藏凶機
Hector and the Search for Happiness	尋找快樂的15種方法
The Maze Runner	移動迷宮
A Walk Among the Tombstones	鐵血神探
This Is Where I Leave You	愛在頭七天
Tusk	人型海象
Saint Laurent	巴黎聖羅蘭
The Equalizer	私刑教育
The Boxtrolls	怪怪箱
Gone Girl	控制
Annabelle	安娜貝爾
Left Behind	末日迷蹤
The Good Lie	扭轉命運的樂章
Dracula: Untold	德古拉：永咒傳奇
The Judge	大法官
Addicted	危情癮難耐
Alexander and the Terrible, Horrible, No Good, Very Bad Day	亞歷山大衰到家
Kill the Messenger	告密者
Fury	怒火特攻隊
The Book of Life	曼羅奇遇記
The Best of Me	有你，生命最完整
St. Vincent	歐吉桑鄰好
Birdman	鳥人
Dear White People	親愛的白人
Young Ones	旱地復仇
Camp X-Ray	戰犯風暴
Love, Rosie	親愛的，原來是你
Ouija	碟仙
John Wick	捍衛任務
Laggies	大愛晚成
Nightcrawler	獨家腥聞
Interstellar	星際效應
Big Hero 6	大英雄天團
The Theory of Everything	愛的萬物論
Jessabelle	母難日
The Better Angels	少年林肯
Dumb and Dumber To	阿呆與阿瓜：賤招拆招
Beyond the Lights	燈光之外
Rosewater	叛諜風暴
Saving Christmas	拯救聖誕節
Foxcatcher	暗黑冠軍路
The Hunger Games: Mockingjay – Part 1	飢餓遊戲：自由幻夢 PART I
Penguins of Madagascar	馬達加斯加爆走企鵝
Horrible Bosses 2	老闆不是人2
Paddington	柏靈頓：熊愛趴趴走
The Imitation Game	模仿遊戲
Before I Disappear	在我消失之前
Wild	走出荒野
The Pyramid	驚字塔
Exodus: Gods and Kings	出埃及記：天地王者
Top Five	喜劇人生
Inherent Vice	性本惡
Whiplash	進擊的鼓手
The Hobbit: The Battle of the Five Armies	哈比人：五軍之戰
Night at the Museum: Secret of the Tomb	博物館驚魂夜3
Annie	安妮
The Interview	名嘴出任務
American Sniper	美國狙擊手
Into the Woods	魔法黑森林
Unbroken	永不屈服
The Gambler	玩命賭徒
Big Eyes	大眼睛
A Most Violent Year	暴力年代
Queen of the Mountains	庫爾曼江·達特卡
Tazza 2	千術之神
The Grand Masters	一代宗師
Cha cha for Twins	寶米恰恰
Born to Love You	大叔，我愛你
Love In Time	等我愛你
Desperate Rescue	危情營救
The Thieves	神偷大劫案
The King Of Comedy	喜劇王
Bring Happiness Home	快樂大本營之快樂到家
Beyond the Bounds	越位者
Blame It On The Phone	都是手機惹的禍
Jungle Master	綠林大冒險
The Mythical Ark&#160;: Adventure In Love And Happiness	喜羊羊與灰太狼大電影5喜氣羊羊過蛇年
Pororo's Racing Adventure	波魯魯冰雪大冒險
Little Tigers	小小飛虎隊
Mysterious Island 2	孤島驚魂2
Seven Years	愛呦,阿斗
Angry Kid	憤怒的小孩
Balala the Fairies	巴啦啦小魔仙大電影
Roco kingdom:the desire of dragon	洛克王國2聖龍的心愿
The Chrysalis	女蛹之人皮嫁衣
Hotel Deluxe	百星酒店
The Flying Machine 3D	夢幻飛琴
Mark Of Youth	全城高考
Odyssey	西遊·降魔篇
Better And Better	越來越好之村晚
Love Is Not NG	愛情不NG
Together	倖存日
101st Marriage Proposal	101次求婚
My Wife's A Cat	我的老婆是只貓
Lift to Hell	電梯驚魂
Happy life of YangGuang	楊光的快樂生活
The Love Flu	三月情流感
Midnight Microblog	午夜微博
On The Nan Ni Wan Frontier	南泥灣
Rang Ai Zhan Fang	讓愛綻放
Youthful Days	青春雷鋒
The Sweet Smile	雷鋒的微笑
Lei Feng in 1959	雷鋒在1959
Fall In Love	愛神
Chasing is Hurting	不要迷戀姐
Princess and Seven Kung-fu Masters	笑功震武林
Runaway Women	暴走吧，女人
Falling Flowers	蕭紅
Baby Run	寶貝快跑
Midnight Train	午夜火車
Silent Code	BBS鄉民的正義
Love Deposit	愛情銀行
Scandals	囧人之越撓越癢
Finding Mr. Right	北京遇上西雅圖
82 Warriors	劉老莊八十二壯士
An End To Killing	止殺令
Ip Man Final Fight	葉問：終極一戰
The House	樓
Neverland	夢幻島
The Chef, The Actor, The Scoundrel	廚子戲子痞子
Drug War	毒戰
Saving General Yang	忠烈楊家將
A Cherry on a Pomegranate Tree	石榴樹上結櫻桃
The Action Zero	變身超人
Sweet Eighteen	甜蜜十八歲
The Deadly Bullet	刺夜
Conspirators	同謀
When A Wolf Falls In Love With A Sheep	南方小羊牧場
Xi Bai Po: Wang Er Xiao	西柏坡2：王二小
Lucky Dog	石器時代之百萬大偵探
The Incredible Truth	瘟泉
Mr. & Mrs. Gambler	爛賭夫鬥爛賭妻
Qu Li Qiang	渠立強
Love Speaks	意外的戀愛時光
Beloved	親愛
Piano Trojan	鋼琴木馬
Fallen City	傾城
Indomitable Soldiers	殘團
Mortician)	臨終囧事
American Dreams in China	海闊天空
Christmas Rose	聖誕玫瑰
Running All The Way	一路狂奔
Don't talk about High-Rich and Handsome	別跟我談高富帥
The Charge	衝鋒號
Sun Face	太陽臉
The Wedding Diary	結婚那件事
Happy Little Submarine 3: Rainbow Treasure	潛艇總動員3--彩虹寶藏
The Adventures of Sinbad 2013	辛巴達歷險記2013
Let Panda Fly	讓熊貓飛
Yang Guang Liu Shou	陽光留守
I Love Hong Kong 2013	2013我愛HK 恭囍發財
Touch of the Light	逆光飛翔
Redemption	殺戒
Ye Mu Jing Hun	夜幕驚魂
Glory Days	光輝歲月
The Cosplayers	百萬愛情寶貝
Switch	天機：富春山居圖
The Soccer Way	聖龍奇兵大冒險
Block Buster	大片
Mysterious Face	枕邊有張臉
Time to Show	非秀不可
Love you forever	愛·你別走
A Style of a man in beijing	北漂魚
Badges Of Fury	不二神探
Tiny Times 1.0	小時代
Oriental Chinese Dream	東方中國夢
Kai Xin Chao Ren	開心超人
Singing When We Are Young	初戀未滿
Blind Detective	盲探
Man of Tai Chi	太極俠
The Deadly Strands	咒絲
Crutch	拐杖
The Rooftop	天台
The Supernatural Events on Campus	校花詭異事件
Seer III	賽爾號大電影3之戰神聯盟
Bunshinsaba 2	筆仙Ⅱ
The Story Of Zhou Enlai	周恩來的四個晝夜
Mr.GO	王牌巨猩
Day of Redemption	早見，晚愛
Kung Fu Man	功夫俠
Adventure at Flaming Moutains	火焰山歷險記
The Ultimate Task	終極大冒險
Yong Chun Xiao Long	詠春小龍
Chinese Look	正骨
Love Is Beautiful	愛,很美
Avalokitesvara	不肯去觀音
Ghost of Model	模特魅影
I Love wolffy 2	我愛灰太狼2
Young Style	青春派
Love Story	愛愛囧事
Bang Jia Da Ming Xing	綁架大明星
Tiny Times 2.0	小時代：青木時代
Crimes of Passion	一場風花雪月的事
Saving Mother Robot	瑪德2號
Where is the paradise	情緣廊橋
One Night Surprise	一夜驚喜
Hai Qi, Da Ta Ge Gui Zi	嗨起，打他個鬼子
The Palace	宮鎖沉香
The Best Kids	小神來了
Train Heroes	高鐵英雄
Gui Yan	詭魘
Unbeatable	激戰：勇者不敗
Lips and Soul	唇唇欲動
Ox Thief	牛膽神偷
A Moment Of Love	回到愛開始的地方
Pink Lady：Lover Run	粉紅女郎·愛人快跑
Unidentified	來歷不明
Fake Fiction	摩登年代
Night Blooming	隔窗有眼
The Stolen Years	被偷走的那五年
I am Director	瘋狂的導演
Sweet Summer Love	夏日示愛
Flash Play	致命閃玩
The Midas Touch	超級經理人
Timeless love	時光戀人
Dead Sign	古鎮凶靈之巫咒纏身
A Young Girl's Destiny	逆襲
Ripples of Desire	花漾
4B Qing Nian Zhi 4 Lou B Zuo	4B青年之4樓B座
Xiao Che	校車 (電影)
Silent Witness	全民目擊
My Lucky Star	非常幸運
Luo Jing Shan	落經山
My Mother	我的母親 (中國電影)
Love Distance	愛別離
The Ideal City	一座城池
The Empire Symbol	帝國秘符
Mayday NOWHERE 3D	五月天諾亞方舟
The Warth Of Vajra	金剛王：死亡救贖
The Fox Lover	白狐
Young Detective Dee: Rise of the Sea Dragon	狄仁傑之神都龍王
Farm House 81	81號農場之保衛麥咭
Bump In The Road	一路順瘋
Inferno 3D	全面封鎖
Amazing	神奇
Murcielago	蝙蝠別墅
72 Hours of Sword Robbing	盜劍72小時
Ba Men Jiang Jun	門巴將軍
Cross	第6誡
The Game Of Hide And Seek	禁忌的遊戲之迷藏
Love Will Tear Us Apart	我想和你好好的
Target Locked	目標戰
The Love Songs of Tiedan	美姐
Special ID	特殊身份
Pricess Show	公主的誘惑
Fall of Ming	大明劫
Striving in Beijing With Love	愛拼北京
Devil‘s right hand	制服
Baby Blues	詭嬰
Cold pupil	冷瞳
Pay Back	獵仇者
Angel Warriors	鐵血嬌娃
The Constable	衝鋒戰警
Dating Fever	我為相親狂
The Twins' Code	孿生密碼
Beijing Flickers	有種
Love You For Loving Me	我愛的是你愛我
Love Go Home	愛·回家
Sweetheart Chocolate	甜心巧克力
Carpooling Shock	詭拼車
Bachelors' love	光的棍
Black Mirror	少女靈異日記
Bu Bu Zhui Hun	步步追魂
My Boyfriends	我的男男男男朋友
KungFu Fighter	功夫戰鬥機
Love is Touch	愛情碰碰撞
An Irasclble Angel	暴躁天使
High Kickers	捨身技
The Wild Strawberries	野草莓
Love Transplantation	幸福快遞
The Falling Feather	飄落的羽毛
Votage Extraordinaire 3D	鄭和1405：魔海尋蹤
The Four 2	四大名捕II
Nanny's Love	乳娘情
Fire Storm	風暴
Rhythm of the Rain	聽見下雨的聲音
Return The Money	啊朋友還錢
My Beautiful Kingdom	我的美麗王國
China Heavyweight	千錘百鍊
Dancing in the Room	房間裡的舞蹈
Game of Assassins	刺客
Mao Zedong and Qi Baishi	毛澤東與齊白石
You Zhao Mei Zhao	有招沒招之愛情達人
I Want You	中國好聲音之為你轉身
Lost	迷魂之密室逃脫
The Frog Kingdom	青蛙王國
Up in the wind	等風來
The Last Tycoon	大上海
The Last Supper	王的盛宴
Young and Dangerous: Reloaded	古惑仔：江湖新秩序
One Tree Three Lives	三生三世聶華苓
Keening Woman	哭喪女
Whoever	愛誰誰
Lost In Thailand	人再囧途之泰囧
Iron Man Wang Jin Xi	鐵人王進喜
Finding Mr.Right	北京遇上西雅圖
Will You Still Love Me Tomorrow?	明天記得愛上我
I Love You, Mom	媽媽，我愛您
When Night Falls	我還有話要說
Tales Dark 1	迷離夜
SDU: Sex Duties Unit	飛虎出征
Tales Dark 2	奇幻夜
The Way We Dance	狂舞派
Apolitical Romance	對面的女孩殺過來
Taipei Factory	台北工廠
Hardcore Comedy	重口味
A Secret Between Us	第一次不是你
Mr. & Mrs. Player	爛滾夫鬥爛滾妻
Tiny Times 2	小時代 2&#160;: 青木時代
Rigor Mortis	殭屍
-197°C Murder	冰裸殺
Zone Pro Site	總舖師
Rock Me To The Moon	一首搖滾上月球
Sock’n Roll	台灣黑狗兄
Bridge Over Troubled Water	拔一條河
As the Winds Blow	戀戀海灣
Fish Story	子非魚
Good Luck! Boy	加油！男孩
ILO ILO	爸媽不在家
4 in Life	四季人生
Doomsday Party	末日派對
LIVE IN LIVE	現場·戰場·夢工廠
When C Goes with G7	當C遇上G7
The Triangle Land	三角地
Machi Action	變身
Killing 7	追魂7殺
To My Dear Granny	親愛的奶奶
David Loman	大尾鱸鰻
Get Together	逗陣ㄟ
Step Back to Glory	志氣
Faithball	天后之戰
Forever Love Grandma	阿嬤的夢中情人
The Harbor	港都
Guns N'Roses	黃金大劫案
Back to 1942	一九四二
Face To Face	正面迎擊
Caught in the Web	搜索
27℃-Loaf Rocks	世界第一麥方
Shining Dancing	舞力四射
Tales Dark 1</span></i><span lang="en" xml:lang="en">/<i>Tales from t	鬼夜
Tomorrow Comes Today	你的今天和我的明天
Attabu	阿罩霧風雲
MayDay Nowhere3D	5月天諾亞方舟
A Little Bird	我是隻小小鳥
Star of bethlehem	微光閃亮第一個清晨
Trekking The Way Home	縱行囝仔
100 Days	真愛100天
Mida	夢見
Chiu-Hsiang	秋香
Ghost Child	鬼仔
Lost in Thailand	人再囧途之泰囧
Kara King	冠軍歌王
A Time in Quchi	暑假作業
Texas Chainsaw 3D	德州電鋸殺人狂3D
A Dark Truth	黑暗真相
A Haunted House	鬼屋電影
Gangster Squad	風雲男人幫
Mama	母侵
Broken City	驚爆危城
The Last Stand	重擊防線
Hansel And Gretel: Witch Hunters	女巫獵人
John Dies at the End	死亡盡頭
Knife Fight	選戰風暴
Movie 43	激愛543
Parker	偷天派克
Warm Bodies	殭屍哪有這麼帥
Bullet to the Head	頭號目標
Stand Up Guys	王牌雙賊
Identity Thief	竊資達人
Side effects	藥命關係
A Glimpse Inside the Mind of Charles Swan III	變腦漫遊中
A Good Day to Die Hard	終極警探：跨國救援
Safe Haven	愛情避風港
Beautiful Creatures	美麗魔物
Escape from Planet Earth	地球人壞壞
Snitch	限時翻供
Dark Skies	黑暗天際
Jack the Giant Slayer	傑克：巨人戰紀
21 and Over	醉後大學生
The Last Exorcism Part II	最後大法師2
Phantom	幻影計劃
Stoker	慾謀
Oz the Great and Powerful	奧茲大帝
Dead Man Down	無間殺手
The Call	絕命連線
The Incredible Burt Wonderstone	王牌魔術師
The Croods	古魯家族
Olympus Has Fallen	全面攻佔：倒數救援
Admission	愛情招生處
G.I. Joe: Retaliation	特種部隊2：正面對決
The Host	宿主
The Place Beyond the Pines	末路車神
Temptation: Confessions of a Marriage Counselor	一位婚姻顧問的自白
Andre Gregory: Before and After Dinner	晚餐前後
Upstream Color	逆流色彩
Evil Dead	屍變
42	傳奇42號
Scary Movie 5	驚聲尖笑5
Disconnect	疏離世界
Oblivion	遺落戰境
Pain & Gain	不勞而禍
The Big Wedding	婚禮大聯矇
Iron Man 3	鋼鐵人3
About Time	真愛每一天
The Great Gatsby	大亨小傳
Peeples	皮爾普斯一家
Star Trek Into Darkness	闇黑無界：星際爭霸戰
Black Rock	黑色搖滾
The Hangover Part III	醉後大丈夫3
Blue Is the Warmest Color	藍色是最溫暖的顏色
Fast & Furious 6	玩命關頭6
Epic	森林戰士
Now You See Me	出神入化
After Earth	地球過後
The Purge	國定殺戮日
The Internship	實習大叔
This Is the End	大明星世界末日
Man of Steel	超人：鋼鐵英雄
Kick-Ass 2	特攻聯盟2
Monsters University	怪獸大學
World War Z	末日之戰
Much Ado About Nothing	無事生非
The Heat	麻辣嬌鋒
White House Down	白宮末日
Despicable Me 2	神偷奶爸2
The Lone Ranger	獨行俠
Kevin Hart: Let Me Explain	讓我解釋
Grown Ups 2	亞當等大人2
Pacific Rim	環太平洋
Fruitvale Station	奧斯卡的一天
Turbo	渦輪方程式
The Conjuring	厲陰宅
Red 2	超危險特工2：狠戰
R.I.P.D	降魔戰警
The Wolverine	金鋼狼：武士之戰
The To Do List	大學生"做"了沒？
The Smurfs 2	藍色小精靈2
2 Guns	2槍斃命
We're the Millers	全家就是米家
Percy Jackson: Sea of Monsters	波西傑克森：妖魔之海
Elysium	極樂世界
Planes	飛機總動員
The Butler	白宮第一管家
Paranoia	決勝機密
The Mortal Instruments: City of Bones	天使聖物：骸骨之城
The World's End	醉後末日
You're Next	你是下一個
Blue Jasmine	藍色茉莉
Closed Circuit	全面鎖定
One Direction: This Is Us	1世代：我們的世代
Instructions Not Included	重點是，我愛你
Getaway	死路十條
Riddick	超世紀戰警：闇黑對決
Insidious: Chapter 2	陰兒房第2章：陰魂守舍
Prisoners	私法爭鋒
Rush	決戰終點線
Battle of the Year	BOTY世界Battle
Cloudy with a Chance of Meatballs 2	食破天驚2
Baggage Claim	行李帶
Don Jon	超急情聖
Runner Runner	逆轉王牌
Gravity	地心引力
Captain Phillips	怒海劫
Machete Kills	殺千刀重出江湖
The Family	黑幫追殺令
Carrie	魔女嘉莉
Escape Plan	鋼鐵墳墓
Jackass Presents:Bad Grandpa	無厘取鬧:祖孫卡好
The Counselor	玩命法則
Ender's Game	戰爭遊戲
Last Vegas	賭城大丈夫
Free Birds	火雞反擊戰
Dallas Buyers Club	藥命俱樂部
Haunts	亡魂出沒
Thor: The Dark World	雷神索爾2：黑暗世界
12 Years a Slave	自由之心
Charlie Countryman	這該死的愛
The Hunger Games: Catching Fire	飢餓遊戲：星火燎原
Delivery Man	百萬精先生
Frozen	空中驚魂夜
Homefront	最後防線
The Book Thief	偷書賊
Oldboy	原罪犯
Out of the Furnace	逃出鎔爐
The Hobbit: The Desolation of Smaug	哈比人：荒谷惡龍
A Madea Christmas	黑瘋婆娘的聖誕節
Saving Mr. Banks	大夢想家
Anchorman 2: The Legend Continues	銀幕大角頭2：傳奇再續
Walking With Dinosaurs 3D	與恐龍冒險3D
Lone Survivor	紅翼行動
American Hustle	瞞天大佈局
The Wolf of Wall Street	華爾街之狼
The Secret Life of Walter Mitty	白日夢冒險王
47 Ronin	浪人47
Grudge Match	進擊的大佬
August: Osage County	八月心風暴
The Tower	火海108
Miracle in Cell No. 7	戇爸的禮物
What's So Special About Rina	麗娜有甚麼
Snowpiercer	末日列車
The Wind Rises	風起
Xi Jiu	喜酒
Run	絕錄求生
The Killer Who Never Kills	殺手歐陽盆栽
You Are the Apple of My Eye	那些年，我們一起追的女孩
Song And Moon	行歌坐月
Happy Adventure	開心大冒險
Mission Incredible: Adventures On The Dragon's Trail	喜羊羊與灰太狼之開心闖龍年
The Great Magician	大魔術師
The Viral Factor	逆戰
Qing Jia Guo Nian	親家過年
All's Well End's Well 2012	八星抱喜
Fan Ju Ye Feng Kuang	飯局也瘋狂
Just For Fun	就是鬧著玩的
New Perfect Two	新天生一對
Harpoon	驚魂遊戲
Chao Shi Kong Jiu Bing	超時空救兵
If I Were You	變身男女
Life Without Principle	奪命金
Bottom line	絕對底線
I Romancing In Thin Air	高海拔之戀II
Ye Dian Gui Tan	夜店詭談
I Do	我願意
Truth or Brave	真心話大冒險
The Floating Shadow	浮出水面的影子
Bang Bang Formosa	烏龍戲鳳2012
Scheme With Me	雙城計中計
The Sword Identity	倭寇的蹤跡
Feng Kuang De Chun Zei	瘋狂的蠢賊
Hsue-shen Tsien	錢學森
Nun Chucks	雙截棍
Turning Point 2	Laughing Gor之潛罪犯
The Second Woman	情謎
Jack Of All Traces	神通鄉巴佬
Love Lifting	高舉愛
A Simple Life	桃姐
The Locked Door	女人如花
Liu Ru Shi	柳如是
The Somalia Truth	索馬利亞真相
Rhapsody of Marriage	結婚狂想曲
Night Fall	大追捕
You and Me	我和你
Marrying Mr. Perfect	嫁個100分男人
Tokyo Newcomer	初到東京
Late Autumn	晚秋
The bloody marriage	死亡迷局
Joyful Reunion	飲食男女2：好遠又好近
The Happy Kids Adventure	囧蛋奇兵
Love On Gallerv Bridge	愛在廊橋
Everything is Nothing	神馬都是浮雲
Love in The Buff	春嬌與志明
Blood Stained Shoes	繡花鞋
The Next Magic	下一個奇蹟
JUST TRY ME	關於愛情和那些魔鬼
The Unfortunate Car	車在囧途
Snow Fall in Taipei	台北飄雪
Dive In	這一刻，愛吧！
Huang Dao Qing Wei Liao	荒島情未了
One Night To Be Star	一夜成名
Love On That Day	愛在那一天
I'm Chinese	我是中國人
An Inaccurate Memoir	匹夫
Lao Ren Yuan	老人願
Camel Caravan	駱駝客
Close to the Sun	雲上太陽
Design Of Death	殺生
Happy Panda	我是大熊貓
Long Tou	龍頭
Inseparable	形影不離
To my wife	與妻書
Mystery Fobber	月色猙獰
Son of Stars	星星的孩子
Full Circle	飛越老人院
Warriors of the Rainbow	賽德克·巴萊
Jin Tian Ming Tian	今天·明天
Believe In Love	初戀淺規則
Repeat I Love You	影子愛人
Fairy Tale Killer	追兇
Death Zone	地域無門
11 flowers	我十一
Hundred Years of A Floating City	浮城大亨
Live or death in Lop Nor	生死羅布泊
Loyalty and Betrayal	忠誠與背叛
The Struggling Ants	狂奔螞蟻
LA LA	我與拉拉
I'm Here For You	為你而來
Passion Island	熱愛島
Lacuna	醉後一夜
The Thirty-Seven	三十七
Pubescence 3	青春期3
BiXian Panic	筆仙驚魂
The First Time	第一次
Million Dollar Crocodiler	百萬巨鱷
Under The Temptation	四戒
Double Trouble	寶島雙雄
Who in the mirror	半夜不要照鏡子
Ever Loving Ocean Of Blues	藍調海之戀
To Forgive	查無此人
I Love Hong Kong 2	2012喜上加喜
Black & White Episode I	痞子英雄之全面開戰
Diaries of the Cheating Hearts	擒愛記
The Sword of Love	潘多拉的寶劍
The Brother	黑暗中的救贖
The Bounty	懸紅
Motorway	車手
Painted Skin：The Resurrection	轉生術
Zhu Zhu Xia Zhi Jiong Jiong Wei Ji	豬豬俠之囧囧危機
SeerⅡ	賽爾號2：雷伊與邁爾斯
The mask of love	魅妝
Young Blood	青春搏擊
Very Kidnappers	非常綁匪
Legend of The Moles-Treasure of Scylla	摩爾莊園2海妖寶藏
Wu Dang	大武當之天地密碼
The Pork of Music	麥兜噹噹伴我心
Jia Wu Da Hai Zhan	一八九四・甲午大海戰
Qing Yan	青魘
THE FOUR	四大名捕
Song of Silence	楊梅洲
The Soul of Bread	愛的麵包魂
The Zodiac Mystery	十二星座離奇事件
Naked Soldier	絕色武器
Bunshinsaba	筆仙
Be A Mother	母語
Bao Ma Kuang Xiang Qu	寶馬狂想曲
Beijing Blues	神探亨特張
Fearless	熱血街頭
Da Cun Gu	大村姑
The King of The Streets	街頭之王
Happy Hotel	樂翻天
People Mountain People Sea	人山人海
Good-For-Nothing Heros	請叫我英雄
Meet The In Laws	搞定岳父大人
The Silent War	聽風者
Bateelaer saga	巴特拉爾傳說
The Adventures of Jinbao	大兵金寶曆險記
Yugo&Lala	神秘世界歷險記
I Love Wolffy	我愛灰太狼
Shanghai Calling	紐約客@上海
The Bullet Vanishes	消失的子彈
Diva	DIVA華麗之後
The Lion Roars 2	河東獅吼2
The Fierce Wife Final Episode	犀利人妻最終回：幸福男·不難
Lethal Hostage	邊境風雲
Substitute Millionaire	做次有錢人
Horrible Hotel	恐怖旅館
Flying with you	一起飛
Holding Love	Hold住愛
Decrepit Dream	殘夢
Insistence	守株人
Laugh and Cry Forbidden	哭笑不得
The Fortune Buddies	勁抽福祿壽
Thousand Year Love	雲之錦
Fairy Tales	都市童話
Let it be	稍安勿躁
Yin Qing Yuan Que	因情圓缺
Sad Fairy Tale	傷心童話
White Deer Plain	白鹿原
Cai Jin	孝女彩金
The Tree In The Rain	雨中的樹
Great Rescue	非常營救
That Year School Ended	畢業那年
The Assassins	銅雀台
Dangrous Liaisons	黑色終結令
Taichi0	太極1從零開始
Double Xposure	二次曝光
Moonlight Love	月光戀
Little man	美男記
WINGS	最長的擁抱
Time Flies Soundlessly	歲月無聲
Wu Ren Bao	吳仁寶
Love is. . .Pyjamas	男人如衣服
Big Bowl of Beijing Tea	大碗茶
The Line	界限
Battlefield Orchid	湘南起義
My Way	乾旦路
All For Love	三個未婚媽媽
Haunting Love	詭愛
The Next 11 Days	冰雪11天
TaichiⅡ	太極2英雄崛起
Hushed Roar	咆哮無聲
Cold War	寒戰
Mobile Hospital	橫山號
Predetined Around Us	緣來是咱倆
Natural Born Lover	這個男人有點色
Happiness Me Too	幸福迷途
Tears in Heaven	新媽媽再愛我一次
Chrysanthemum to The Beast	給野獸獻花
The KungFu Master	八卦宗師
Feng Shui	萬箭穿心
Hoed to you	借你倆膽
Goust Double	致命替身
Sky Love	戀愛三萬英尺
Zombies Reborn	無間罪：殭屍重生
The flight of youth	飛揚的青春
Smile Walked	笑過2012
Kill The Boss	小魚吃大魚
My Sassy Hubby	我老公唔生性
Singular Puzzle	異度迷局
The Guillotines	血滴子
Chinese Zodiac	十二生肖
Bleeding Mountain	凶間雪山
Love of Shajingcun	沙井村之戀
The Peach of Taozhi	桃枝的桃
Secret Garden	秘密花園
The Basenent	地下室驚魂
Love Dog Doc	我的狗狗我的愛
The Grow	金箍棒傳奇
Promise Time	玩命時光
The Fierce Wife	犀利人妻
Speed Angels	極速天使
The Flowers Of War	金陵十三釵
I Love Hong Kong 2012	2012我愛HK 喜上加囍
the tears	傾城之淚
Love Is Not Blind	失戀33天
One Nation, Two Cities	一國雙城
Love Actually... Sucks	愛很爛
10+10	10+10
The soul of bread	愛的麵包魂
One Nation Two Cities	一國雙城
Lives In Flames	起勢搖滾
Any Other Side	夜店詭談
Snowfall in Taipei	臺北飄雪
Floating City	浮城
Bad Girl	女孩壞壞
The Cases	魕
Coweb	戰．無雙
Din Tao: Leader of the Parade	陣頭
Shadows of Love	影子愛人
Vulgaria	低俗喜劇
Lan Kwai Fong II	喜愛夜蒲2
GF。BF	女朋友。男朋友
We Not Naughty	孩子不壞
Black & White Episode I: The Dawn of Assault	痞子英雄首部曲：全面開戰
Naked Human Nature	赤裸人性
Cold Steel	遍地狼煙
Dear Enemy	親密敵人
$upercapitalist	商戰
N＋N	N＋N
Triad	紮職
Love Me No	不能愛
The Unbelievable 2: Channeling the Spirits	怪談電影 - 撩鬼
Go Grandriders	不老騎士
Sky Ladder	天梯
Flying Dragon, Dancing Phoenix	龍飛鳳舞
Perfect Two	新天生一對
Bang! Bang! Formosa	寶島大爆走
Bear It	熊熊愛上你
When Yesterday Comes	昨日的記憶
Great Wall My Love	追愛
The Third Wish	第三個願望
Bad Girls	女孩壞壞
The Bird Who Saved the World	什麼鳥日子
Zombie 108	Z-108棄城
Jumping Boy	不倒翁的奇幻旅程
Come for You	為你而來
Prima Donna	當家花旦
Love is Sin	白天的星星
My Little Honey Moon	內人／外人－野蓮香
The Happy Life of Debbie	內人／外人－黛比的幸福生活
The Golden Child	內人／外人－金孫
The Moonlight in Jilin	內人／外人－吉林的月光
Common Heroes	貧民英雄
Melody	腳趾上的星光
Cha-Cha for Twins	寶米恰恰
Father's Lullaby	手機裡的眼淚
Inky Soul	墨魂
Gf & Bf	女朋友。男朋友
Viva Baseball	球來就打
Young Dudes	騷人
Westgate Tango	西門町
The Ghost Tales	變羊記
A Story About Banana	我不窮，我只是沒有錢
Stilt	候鳥的季節
Legend of The T-dog	命運狗不理
Beauty and the Beast (3D)	美女與野獸3D
Contraband	禁運品
Red Tails	紅尾戰鷹
Underworld Awakening	決戰異世界：未來復甦
The Grey	即刻獵殺
Man on a Ledge	驚天換日
Chronicle	超能失控
Journey 2: The Mysterious Island	地心冒險2：神祕島
Safe House	狡兔計畫
Star Wars: Episode I - The Phantom Menace	星際大戰首部曲：威脅潛伏3D
The Vow	愛重來
This Means War	特務愛很大
My Week with Marilyn	夢露與我的浪漫週記
Extremely Loud and Incredibly Close	響在耳邊，近在眼前
Ghost Rider Spirit of Vengeance	惡靈戰警：復仇時刻
The Secret World of Arrietty	借物少女艾莉緹
Act of Valor	海豹神兵：英勇行動
Gone	致命救援
Wanderlust	隨心所欲
Dr. Seuss' The Lorax	羅雷司
Project X	派對X計劃
John Carter	異星戰場：強卡特戰記
A Thousand Words	千字遺言
21 Jump Street	龍虎少年隊
The Hunger Games	飢餓遊戲
Mirror Mirror	魔鏡，魔鏡
Wrath of the Titans	怒戰天神
Titanic	鐵達尼號
American Reunion	美國派4：美國重逢
The Cabin in the Woods	詭屋
Lockout	天外封鎖線
The Three Stooges	三個臭皮匠
Chimpanzee	黑猩猩
The Lucky One	幸運符
Think Like a Man	讀懂男人心
The Five-Year Engagement	五年之約
The Pirates! Band of Misfits	海賊天團
The Raven	神探愛倫坡：黑鴉疑雲
Safe (2011)	火線反擊
The Avengers	復仇者聯盟
Dark Shadows	黑影家族
Girl in Progress	女孩向前衝
The Dictator	大獨裁者落難記
Battleship	超級戰艦
What to Expect When You're Expecting	好孕一起來
The Hunt	謊言的烙印
Chernobyl Diaries	重返車諾比: 鬼城實錄
MIB 3	MIB星際戰警3
Battlefield America	舞林對決
For Greater Glory	更大的輝煌
Snow White and the Huntsman	公主與狩獵者
Piranha 3DD	3D食人魚2：全面獵殺
Madagascar 3: Europe's Most Wanted	馬達加斯加3：歐洲大圍捕
Prometheus	普羅米修斯
That's My Boy	我老爸卡好
Rock of Ages	搖滾時代
Abraham Lincoln: Vampire Hunter	吸血鬼獵人：林肯總統
Brave	勇敢傳說
Seeking a Friend for the End of the World	末日情緣
Magic Mike	魔力麥克
People Like Us	平凡人生
Ted	熊麻吉
Madea's Witness Protection	黑瘋婆的證人保護計劃
The Amazing Spider-Man	蜘蛛人：驚奇再起
Katy Perry: Part of Me	凱蒂佩芮：做我自己
Savages	野蠻告白
Ice Age: Continental Drift	冰原歷險記4：板塊漂移
The Dark Knight Rises	黑暗騎士：黎明昇起
The Watch	巡邏驚很大
Step Up Revolution	舞力全開4
Diary of a Wimpy Kid: Dog Days	遜咖冒險王3
Total Recall	攔截記憶碼
The Bourne Legacy	神鬼認證4
The Campaign	官賤對決
Hope Springs	希望噴泉
The Expendables 2	浴血任務2
The Odd Life of Timothy Green	小芽的口白人生
ParaNorman	派拉諾曼：靈動小子
Sparkle	璀璨人生
Hit & Run	飆客找麻煩
Premium Rush	超急快遞
The Possession	聚魔櫃
Lawless	野蠻正義
To the Wonder	愛‧穹蒼
The Words	千言萬語
The Cold Light of Day	冷光線索
Arbitrage	套利交易
Finding Nemo 3D	海底總動員3D
Resident Evil: Retribution	惡靈古堡5：天譴日
Dredd	新特警判官
End of Watch	火線赤子情
House at the End of The Street	街角最後那棟房子
Trouble with the Curve	人生決勝球
Hotel Transylvania	尖叫旅社
Looper	迴路殺手
Pitch Perfect	歌喉讚
Won't Back Down	永不放棄
Now Is Good	愛正好
Frankenweenie	科學怪犬
Taken 2	即刻救援2
Argo	亞果出任務
Atlas Shrugged: Part II	阿特拉斯聳聳肩
Here Comes the Boom	肉腳擂台
Seven Psychopaths	瘋狗綁票令
Sinister	凶兆
Alex Cross	FBI重裝戒備
Paranormal Activity 4	鬼入鏡4
Chasing Mavericks	衝破極限
Cloud Atlas	雲圖：穿越過去未來
Silent Hill: Revelation 3D	沉默之丘2：啟示錄
Flight	機密真相
The Man with the Iron Fists	鐵拳男子
Wreck-It Ralph	無敵破壞王
Skyfall	007：空降危機
The Twilight Saga: Breaking Dawn Part 2	暮光之城：無懼的愛4：破曉
Lincoln	林肯
Life of Pi	少年PI的奇幻漂流
Red Dawn (2012)	紅潮入侵
Rise of the Guardians	捍衛聯盟
The Collection	蒐屍魔
Killing Them Softly	殺戮行動
Ruby Sparks	客製化女神
Les Misérables	悲慘世界
Django Unchained	決殺令
Out of Control	失控
Shaolin	新少林寺
Pleasant Goat and Big Big Wolf	喜羊羊與灰太狼之虎虎生威
My Own Swordsman	武林外傳
I Love HongKong	我愛HK開心萬歲
All's Well End's Well 2011	最強囍事
Mr.& Mrs. Incredible	神奇俠侶
What Women Want	我知女人心
Under The Influence	戒菸不戒酒
Eternal Moment	將愛情進行到底
Somebody to Love	我們約會吧
Legend of The Aroma City	芳香之城傳奇
She Zhou	蛇咒
Buddha Mountain	觀音山
Fatal Invitation	致命請柬
Sweet Journey	雲下的日子
Sky Fighters	殲十出擊
The Dragon Pearl	尋龍奪寶
Big Big Man	大人物
The Butcher, the Chef, and the Swordsman	刀見笑
The Story of A Piano	琴動我心
House Mania	房不剩防
The Man Behind the Courtyard House	守護者：罪惡迷途
Don't Go Breaking My Heart	單身男女
Children From The Distant Planet	遙遠星球的孩子
The Detective 2	B+偵探
Mr. Zhai	宅男總動員：女神歸來
He-Man	硬漢2奉陪到底
Stand By Me	奮鬥
The Frightening Night	夜驚魂
Choy Lee Fut	蔡李佛
Deadly Will	囧探佳人
Mr. & Mrs. Single	戰國
The Law Of Attraction	萬有引力
Once Upon a Time in Tibet	西藏往事
A Chinese Ghost Story	倩女幽魂
The Ultimate Winner	贏家
The Lost Bladesman	關雲長
Bright Sunshine	大太陽
Love For Life	最愛
Choileefat	蔡李佛拳
A Beautiful Life	不再讓你孤單
To My Wife	百年情書
Where Are You From?	你是哪裡人
Give me a kiss	親親我
No.32,B District	B區32號
Sui Sui Qing Ming	歲歲清明
Case Sensitive	敏感事件
Beginning of The Great Revival	建黨偉業
Love Finally	男得有愛
Snow Flower and the Secret Fan	雪花與秘扇
The Pretending Lovers	假裝情侶
God of Fortune Inn	財神客棧
The Seal of Love	秋之白華
Shen Zhou 11	飛天
The Devil Inside Me	奪命心跳
Swordsmen	武俠
Rest on Your Shoulder	肩上蝶
Mysterious Island	孤島驚魂
kuiba	魁拔
Legend of A Rabbit	兔俠傳奇
Punished	報應
Night Market Hero	雞排英雄
The Piano in a Factory	鋼的琴
Coming Back	回馬槍
Yang Shan-zhou	楊善洲
To Love or Not	一夜未了情
Guo Ming Yi	郭明義
Seer	賽爾號之尋找鳳凰神獸
The Story Of David	蛋炒飯
Xiang Xiao Qiang Yi Yang Huo Zhe	像小強一樣活著
Beach Spike	熱浪球愛戰
Hong Lin Jin	紅領巾
The Wages of Sin	水落石出
L-O-V-E	愛到底
Legend Of The Moles-The Frozen Horror	摩爾莊園冰世紀
No Limit	危情速遞
Overheard 2	竊聽風雲2
Treasure Hunt	無價之寶
Perfect Baby	巴黎寶貝
33 Postcards	美麗謊言
My Kingdom	大武生
Love In Space	全球熱戀
The Woman Knight of the Mirror Lake	競雄女俠-秋瑾
One wrong step	無底洞
72 Heroes	英雄喋血
A Land Without Boundaries	無界之地
1911	辛亥革命
May Day 3DNA	五月天追夢3DNA
The Purple House	紫宅
It's Love	白蛇傳說
Mural	畫壁
Love You You	夏日樂悠悠
Lee's Adventures	李獻計歷險記
I Phone You	愛封了
Who Under The Bed	床下有人
Love Sick	戀愛恐慌症
Love Never Dies	堵車
Love on Credit	幸福額度
Sleepless Fashion	與時尚同居
Scary Market	嘿店
Lost In Panic Cruise	密室之不可靠岸
Sleepwalker in 3D	夢遊3D
The Door With Dad's Love	當爸爸來敲門
Summer Love	戀夏戀夏戀戀下
Starry Starry Night	星空 (2011年電影)
One Mile Above	轉山
Gu Bao Qi Yuan	古寶奇緣
North Point	北角
Love is not Blind	失戀33天
Single no more	光棍魔鬼終結者
Qing Chun Shi Le Yuan	青春失樂園
Mr. Tree	Hello！樹先生
Legendary Amazons	楊門女將之軍令如山
East Meets West 2011	東成西就2011
Fierce midnight dream	午夜凶夢
White Vengeance	鴻門宴
Magic to Win	開心魔法
A Big Deal	巨額交易
Jump A Shin	翻滾吧！阿信
The Treaty of Double Bed	雙人床條約
The Road Less Traveled	一路有你
Lover's Discourse	戀人絮語
Let The Bullets Fly	讓子彈飛
If You Are The One 2	非誠勿擾2
Men Suddenly In Love	猛男滾死隊
Hi Fidelity	出軌的女人
Dont Go Breaking My Heart	單身男女
Sacrifice	趙氏孤兒
The Butcher, the Chef and the Swordsman	刀見笑
Chase Our Love	宅男總動員之女神歸來
3D Sex and Zen: Extreme Ecstasy	3D肉蒲團之極樂寶鑑
Wind Blast	西風烈
The Way We Were	算把啦，老豆！
1+1	1+1
Virtual Recall	異空危情
MicroSex Office	潮性辦公室
The Founding of a Party	建黨偉業
ifva greenlab 2010-2011	委約計劃
Cure	金不換
I Love Wing Chun	笑詠春
Love Is The Only Answer	人約離婚後
The Warring States	戰國
Lan Kwai Fong	喜愛夜蒲
Demon 2	毒禍2
The 33D Invader	蜜桃成熟時33D
The Day of Noah 2 Apocalypse	挪亞方舟驚世啟示2
Roomless	不設房
Seediq Bale	賽德克.巴萊(上):太陽旗
Hong Kong Ghost Stories	猛鬼愛情故事
Let's Go	保衛戰隊之出動喇！朋友！
Big Blue Lake	大藍湖
Seediq Bale Part2	賽德克•巴萊(下)：彩虹橋
Strawberry Cliff	贖命
Mr. Bedman	彈簧床先生
Just Call Me Nobody	大笑江湖
Everlasting Moments	靈魂的旅程
Honey PuPu	消失打看
Goodbye May	走出五月
Memory Loss	憶世界大冒險
Days We Stared at the Sun	他們在畢業的前一天爆炸
Young at Heart: Grandma Cheerleaders	青春啦啦隊
A Departure from Love	與愛別離
Leaving Gracefully	帶一片風景走
Make Up	命運化妝師
Will You Still Love Me	妳是否依然愛我
Formosa Mambo	寶島漫波
Blowfish	河豚
Jump Ashin!	翻滾吧！阿信
You are the Apple of My Eye	那些年，我們一起追的女孩
Seediq Bale I	賽德克·巴萊(上)：太陽旗
MAYDAY 3DNA	五月天3DNA
Seediq Bale II	賽德克·巴萊(下)：彩虹橋
Four hands / Mian Yin Zi	面引子 (電影)
Father(Abba)	阿爸 (電影)
War Game 229	燃燒吧！歐吉桑
The Spin Kid	電哪吒
Hand in Hand	牽阮的手
Inina Ptnaq Na Bcingan	不一樣的月光
Road Less Traveled	樂之路 (電影)
Love sick	戀愛恐慌症
Season of the Witch	魔女神兵
Country Strong	鄉謠情緣
The Green Hornet	青蜂俠
The Dilemma	劈腿困境
Barney's Version	巴尼正傳
No Strings Attached	飯飯之交
The Way Back	亡命千萬里
The Company Men	企業風暴
The Mechanic	極速秒殺
The Rite	現代驅魔師
Kaboom	入侵潛意識：迷幻異域
From Prada to Nada	小姐好窮
Sanctum	3D驚天洞地
The Roommate	小心室友
Waiting for Forever	等到永遠
The Eagle	帝國戰記
Just Go With It	愛情大臨演
Gnomeo and Juliet	糯米歐與茱麗葉
Justin Bieber: Never Say Never	小賈斯汀：永不說不
I Am Number Four	獵殺第四行者
Unknown	狙擊陌生人
Big Mommas: Like Father, Like Son	絕地奶霸：唬父無犬子
Vanishing On 7th Street	消失在第七街
Black Swan	黑天鵝
Drive Angry	3D怒火狂飆
Hall Pass	放風通行證
Rango	飆風雷哥
The Adjustment Bureau	命運規劃局
Beastly	野獸情人
Take Me Home Tonight	今晚帶我回家
Battle: Los Angeles	洛杉矶之战
Red Riding Hood	血紅帽
Mars Needs Moms!	火星需要媽媽
Jane Eyre	簡愛
Black Death	黑死病
Limitless	藥命效應
The Lincoln Lawyer	下流正義
Paul	我們撞到外星人
Sucker Punch	殺客同萌
Diary of a Wimpy Kid 2: Rodrick Rules	遜咖冒險王2
Hop	開運兔
Source Code	啟動原始碼
Insidious	陰兒房
Rubber	超能輪胎殺人事件
Hanna	少女殺手的奇幻旅程
Arthur	阿舍正傳
Your Highness	王子殿下
Soul Surfer	靈魂衝浪人
Rio	里約大冒險
Scream 4	驚聲尖叫4
The Conspirator	刺客共犯
Water for Elephants	大象的眼淚
Madea's Big Happy Family	黑瘋婆子的快樂大家庭
African Cats	非洲大貓
Fast Five	玩命關頭5
Prom	高校舞會
Dylan Dog: Dead of Night	死人之夜
Hoodwinked Too! Hood vs. Evil	小紅帽2
Thor	雷神索爾
Something Borrowed	結婚友沒友
Jumping the Broom	婚禮
The Beaver	海狸先生
Last Night	一夜情迷
Priest	獵魔教士3D
Bridesmaid	伴娘幫幫忙
Pirates of the Caribbean: On Stranger Tides	神鬼奇航：幽靈海
The Hangover Part II	醉後大丈夫2
Kung Fu Panda 2	功夫熊貓2
The Tree of Life	生命樹
X-Men: First Class	X戰警：第一戰
Beginners	新手人生
Super 8	超級8
Judy Moody and the NOT Bummer Summer	朱迪穆迪和不太糟糕的夏天
Midnight in Paris	午夜·巴黎
Green Lantern	綠光戰警
Mr. Popper's Penguins	波普先生的企鵝
Cars 2	汽車總動員2：世界大賽
Bad Teacher	霸凌女教師
Transformers: Dark of the Moon	變形金剛3
Larry Crowne	愛情速可達
Monte Carlo	山寨公主
Horrible Bosses	老闆不是人
Zookeeper	全民情獸
Harry Potter and the Deathly Hallows Part 2	哈利波特—死神的聖物II
Winnie the Pooh	小熊維尼電影版
Captain America: The First Avenger	美國隊長
Friends with Benefits	FWB好友萬萬睡</a>/<a href="/wiki/%E6%88%80%E6%90%9E%E5%A5%BD%E6%9C%8B%E5%8F%8B" title="FWB好友萬萬睡">FWB好友萬萬睡
The Smurfs	藍色小精靈
Cowboys & Aliens	星際飆客
Crazy, Stupid, Love	熟男型不型
The Change-Up	玩咖尬宅爸
Rise of the Planet of the Apes	猩球崛起
The Help	姊妹
Final Destination 5	絕命終結站5
Glee The 3D Concert Movie	歡樂合唱團
30 Minutes or Less	菜鳥搶銀行
Fright Night	吸血鬼就在隔壁
Spy Kids 4: All the Time in the World	小鬼大間諜4
Colombiana	黑蘭煞
Don't Be Afraid of the Dark	別怕黑
Our Idiot Brother	我的傻老哥
The Debt	惡棍狙擊
Shark Night 3D	大白鯊3D
Apollo 18	阿波羅18：不存在的任務
Contagion	全境擴散
Warrior	勇者無敵
Bucky Larson: Born to Be a Star	天生萬人迷
Drive	落日車神
Straw Dogs	稻草狗
I Don't Know How She Does It	凱特的慾望日記
Abduction	在劫難逃
Killer Elite	殺手精英
Moneyball	魔球（電影）
Dolphin Tale 3D	海豚的故事
50/50	活個痛快
What's Your Number?	先生你哪位
Dream House	惡靈凶宅
Real Steel	鋼鐵擂台
The Ides of March	選戰風雲
The Thing	極地詭變
Footloose	2011渾身是勁
The Big Year	觀鳥大年
Paranormal Activity 3	鬼入鏡3
The Three Musketeers	劍客聯盟：雲端之戰
The Mighty Macs	戰勝逆境
Secret of the Wings	奇妙仙子：冬森林的秘密
Anonymous	莎士比亞的祕密
In Time	鐘點戰
Johnny English Reborn	凸搥特派員：二度出包
The Rum Diary	衝擊特寫
The Intouchables	逆轉人生
Puss in Boots	鞋貓劍客
Tower Heist	神偷軍團
A Very Harold & Kumar 3D Christmas	豬頭漢堡包3
Immortals	戰神世紀3D
Jack and Jill	傑克與吉兒
J. Edgar	胡佛傳
Happy Feet 2 in 3D	快樂腳2
Tinker, Tailor, Soldier, Spy	鍋匠 裁縫 士兵 間諜
The Twilight Saga: Breaking Dawn I	暮光之城：無懼的愛：破曉I
Arthur Christmas	聖誕快遞3D
The Muppets	布偶
Hugo	雨果的冒險
Coriolanus	王者逆襲
New Year's Eve	新年前夜
The Sitter	驚夜誰保姆
Alvin and the Chipmunks: Chipwrecked	鼠來寶3D
Sherlock Holmes: A Game of Shadows	福爾摩斯2：詭影遊戲
Mission: Impossible Ghost Protocol	不可能的任務4：鬼影行動
The Girl with the Dragon Tattoo	龍紋身的女孩
The Adventures of Tintin: The Secret of the Unicorn	丁丁歷險記：獨角獸號的秘密
We Bought a Zoo	我們買了動物園
The Darkest Hour	黑暗時刻
War Horse	戰馬
Here Comes Fortune	財神到
Confucius	孔子：決戰春秋
Armor Hero Emperor	鎧甲勇士之帝皇俠
Hong Mao Lan Tu Huo Feng Huang	虹貓藍兔火鳳凰
Lian Huan Kou	連環扣
True Legend	全城熱戀熱辣辣
Little Big Soldier	大兵小將
Season of Good Rain	好雨時節
Eaters	大胃王
Martial Spirit	武動青春
Lu Zhen Chuan Qi	鹿鎮傳奇
Macau 1949	澳門1949
Lan	我們天上見
The Four Cupids	四個丘比特
The Perfect Match	終極匹配
Invisible connection	天上掉下個林妹妹
Go Lala Go！	杜拉拉升職記
Dao Ban Ai Qing	盜版愛情
Yu Shen	預審
Marksman	快槍手
East Wind Rain	東風雨
Side A Side B	A面B面
Like a Dream	如夢
Oriental Casablanca	澳門往事
The Love Of Three Smile-Scholar And The Beauty	三笑之才子佳人
Amor	感情生活
Mawen's Battle	馬文的戰爭
An Urgent Letter	鏢行天下前傳之四百里加急
Confidence Of Banking Stockroom	鏢行天下前傳之庫丁之謎
Illusion Apartment	異度公寓
Lost On Journey	人在囧途
No Kidding	不是鬧著玩的
Kung Fu Pop 2	精舞門2
Yang Xiong Yu Shi Xiu	楊雄與石秀
Love In Cosmo	搖擺de婚約
You Deserve To Be Single	活該你單身
Deep In The Clouds	碧羅雪山
Ocean Heaven	海洋天堂
Money Makes Trouble	小題大做
Heaven Eternal, Earth Everlasting	80'後
Driverless	無人駕駛
Unusual Love	驚情
Xi You Ji	嘻遊記
Ming Tian Shi Fou Lai Lin	明天是否來臨
Flirting Scholar 2	唐伯虎點秋香2之四大才子
Di Yi Shu Ji	第一書記
Aftershock	唐山大地震
Seven Arhat	七小羅漢
My Belle Boss	我的美女老闆
Love In Disguise	戀愛通告
Love Forward	愛要向前沖
Disney High School Musical: China	歌舞青春
Curse of the Deserted	荒村公寓
More Than Close	近在咫尺的愛侶
Wo De Lei Ren Nan You	我的雷人男友
Death and Glory in Changde	喋血孤城
Taste Of Spring	大劫難
Na Na De Mei Gui Zhan Zheng	娜娜的玫瑰戰爭
Sweet Heart	麻辣甜心
Yi Zhi Gou De Da Xue Shi Guang	一隻狗的大學時光
Ice Kacang Puppy Love	初戀紅豆冰
City Monkey	玩酷青春
Let's Fall In Love	我們戀愛吧
Under The Hawthorn Tree	山楂樹之戀
Legend of the Fist: The Return of Chen Zhen	精武風雲·陳真
Reign of Assassins	劍雨
Detective Dee and the Mystery of the Phantom Flame	狄仁傑之通天帝國
Death Dowry	米香
Watch Out For The Bear	熊出沒注意
Love is the Last Word	廬山戀2010
The Island	絕命島
Yi Bu Liu Shen	一不留神
Don Quixote	魔俠傳之唐吉可德
The love Clinic	愛情維修站
Distant Thunder	迷城
Perfect Wedding	抱抱俏佳人
My Ex-wife's Wedding	跟我的前妻談戀愛
Lost In Panic Room'	密室之不可告人
A Singing Fairy	尋找劉三姐
Kong Fu Wing Chun	功夫·詠春
My Sassy Girl 2	我的野蠻女友2
Chongqing Blues	日照重慶
Xin Kang Ding Qing Ge	康定情歌
Legend Of The Swordsman	刀客外傳
Love Tactics	愛情36計
Color Me Love	愛出色
Lao Hu Dou Yao Jia	老虎都要嫁
Bruce Lee, My Brother	李小龍
Super Player	大玩家
Ai Zai Wei Bo Man Yan Shi	愛在微博蔓延時
Paul the Octopus	追蹤章魚保羅
Jeet Kung Do	截拳道
There They Were	此間的少年
Before Memories After Oblivion	回憶之前，忘記之後
Midnight Beating	午夜心跳
West Groovy	哥的傳說
Ex	前度
The Kidnap	綁架冰激凌
Monga	艋舺
Port of Return	靠岸
Tears	眼淚
Au Revoir Taipei	一頁台北
Clownfish	小丑魚
Zoom Hunting	獵豔
Gangster Rock	混混天團
Pinoy Sunday	台北星期天
Taipei Exchanges	第36個故事
Comedy Makes You Cry	拍賣春天
Love You 10000	愛你一萬年
Close to You	近在咫尺
Seven Days in Heaven	父後七日
Rock On!	實習大明星
In Case of Love	街角的小王子
Kingfisher	魚狗
Fantôme, Où es-tu	酷馬
Hip-Hop Storm	街舞狂潮
The Fourth Portrat	第四張畫
My Blind Uncle	阿輝的女兒
When Love Comes	當愛來的時候
Dancing Without You	背著你跳舞
Strike Out	三振
Ending Cut	老徐的完結篇
Tempest of First Love	初戀風暴
The Long Goodbye	被遺忘的時光
Juliets	茱麗葉
Odds in Love	愛情鬥陣
Me, 19	我，十九歲
Black Ransom	撕票風雲
Bad Blood	滅門
Empire of Silver	白銀帝國
14 Blades	錦衣衛
All's Well Ends Well Too 2010	花田囍事2010
72 Tenents of Prosperity	72家租客
Echoes of Rainbow	歲月神偷
Just Another Pandora's Box	越光寶盒
Womb Ghosts	惡胎
Love in a Puff	志明與春嬌
Crossing Hennessy	月滿軒尼詩
Fire of Conscience	火龍
Beauty on Duty	美麗密令
Amphetamine	安非他命
Future X-Cops	未來警察
Ip Man 2	葉問2
Dream Home	維多利亞壹號
Once a Gangster	飛砂風中轉
Gallenets	打擂台
Break Up Club	分手說愛你
The Legend is Born - Ip Man	葉問前傳
Triple Tap	鎗王之王
La Comédie humaine	人間喜劇
Fantastic Water Babes, The	出水芙蓉
Jade and the Pearl, The	翡翠明珠
City Under Siege	全城戒備
All About Love	得閒炒飯
Stool Pigeon, The	綫人
Girl$	囡囡
Showtime	用心跳
Adventure of the King, The	龍鳳店
Child's Eye 3D, The	童眼3D
Haunting Lover, The	借室還魂
Merry-Go-Round	東風破
Vampire Warriors	殭屍新戰士
Most Dangerous Man, The	最·黑色追緝令
Drunkard, The	酒徒
Revenge, A Love Story	復仇者之死
Marriage With A Liar	婚前試愛
Daybreakers	血世紀
Leap Year	敗犬求婚日
Youth in Revolt	宅男卡卡
Crazy on the Outside	出獄一團糟
Bitch Slap	惡女殺很大
Waiting for Armageddon	奔向末日
Wonderful World	美好世界
The Book of Eli	奪天書
The Spy Next Door	鄰家特務
Extraordinary Measures	愛的代價
Legion	暗黑天使
Tooth Fairy	牙仙大帝
To Save a Life	珍愛生命
Edge of Darkness	驚爆萬惡城
When In Rome	羅馬不思議
Dear John	最後一封情書
From Paris With Love	間諜遊戲巴黎
District B13: Ultimatum	暴力特區：極限殺陣
Percy Jackson & the Olympians: The Lightning Thief	波西傑克森：神火之賊
Valentine's Day	情人節快樂
The Wolfman	狼嚎再起
Shutter Island	隔離島
Cop Out	波麗士很忙
The Crazies	屍心瘋
A Prophet	大獄言家
Alice in Wonderland	魔境夢遊
Brooklyn's Finest	惡夜特警隊
Green Zone	關鍵指令
Our Family Wedding	我的家庭婚禮
Remember Me	驚動了愛情
The Bounty Hunter	賞金戀人：Ex檔案
Diary of a Wimpy Kid	遜咖冒險王
Repo Men	索命條碼
Hubble 3D	哈柏太空之旅
The Runaways	翹家女聲
Hot Tub Time Machine	扭轉時光機
How to Train Your Dragon	馴龍高手
The Last Song	最後一首歌
Clash of the Titans	超世紀封神榜
Why Did I Get Married Too?	結婚真好? 2
Date Night	約會喔麥尬
Letters to God	寫給上帝的信
Death at a Funeral	新超完美告別
Kick-Ass	特攻聯盟
The Back-Up Plan	備胎女王
Centurion	世紀戰魂
Furry Vengeance	野蠻大對決
I Love You Phillip Morris	娘子漢大丈夫
A Nightmare on Elm Street	半夜鬼上床：夢殺
Iron Man 2	鋼鐵人2
Just Wright	愛在此時
Robin Hood	羅賓漢
Letters to Juliet	給茱麗葉的信
MacGruber	百戰天龍馬蓋鮮
Shrek Forever After	史瑞克快樂4神仙
Sex and the City 2	慾望城市2
Prince of Persia: The Sands of Time	波斯王子：時之刃
Get Him to the Greek	前往希臘劇院
Killers	刺客公敵
Marmaduke	酷狗馬馬杜
Splice	人工進化
The A-Team	天龍特攻隊
The Karate Kid	功夫夢
Jonah Hex	疤面大鏢客
Toy Story 3	玩具總動員3
Knight & Day	騎士出任務
Grown Ups	亞當等大人
The Twilight Saga: Eclipse	暮光之城：無懼的愛3：蝕
The Last Airbender	降世神通：最後的氣宗
Despicable Me	神偷奶爸
Predators	終極戰士團
The Kids Are All Right	性福拉警報
The Sorcerer's Apprentice	魔法師的學徒
Inception	全面啟動
Standing Ovation	舞動青春
Ramona and Beezus	蕾蒙娜和姐姐
Salt	特務間諜
Life During Wartime	心靈戰火
Cats & Dogs: The Revenge of Kitty Galore	貓狗大戰：珍珠貓大反撲
Charlie St. Cloud	生死情緣
Dinner For Schmucks	豬頭晚餐
The Other Guys	B咖戰警
Step Up 3D	舞力全開3D
The Disappearance of Alice Creed	愛麗絲蒸發奇案
Middle Men	中間人
Twelve	花邊藥頭
The Wildest Dream	最狂野的夢
Cairo Time	開羅時間
Lebanon	黎巴嫩
Patrik, Age 1.5	養子15歲
Eat Pray Love	享受吧！一個人的旅行
The Expendables	浴血任務
Scott Pilgrim vs. the World	歪小子史考特
Tales from Earthsea	地海戰記
La Soga	屠夫之子
Animal Kingdom	動物王國
Peepli Live	霹靂來唬秀
The People I've Slept With	姣妹日記
Salt of this Sea	淚海
Tinker Bell and the Great Fairy Rescue	奇妙仙子：拯救精靈大作戰
Vampires Suck	吸血鬼了沒
A Film Unfinished	未完成的電影
Lottery Ticket	瘋狂大樂透
Nanny McPhee Returns	魔法褓母麥克菲2
Piranha 3D	3D食人魚
The Switch	精選完美男
What If...	假如時光倒流
Mao's Last Dancer	毛澤東時代的最後舞者
The Tillman Story	橄欖球星之死
The Last Exorcism	最後大法師
Takers	偷天搶地
The American	完美狙擊
Going the Distance	真愛零距離
Machete	絕煞刀鋒
Resident Evil: Afterlife	惡靈古堡4：陰陽界
The Virginity Hit	怎樣失去童貞
Never Let Me Go	別讓我走
Alpha and Omega	叢林有情狼
Devil	惡靈電梯
Easy A	破處女王
The Town	竊盜城
Catfish	非識不可
Jack Goes Boating	為愛瘋狂
Last Day of Summer	夏日之末
You Will Meet a Tall Dark Stranger	命中注定，遇見愛
Legend of the Guardians: The Owls of Ga'Hoole	貓頭鷹守護神
Wall Street: Money Never Sleeps	華爾街：金錢萬歲
You Again	冤家囍相逢
Buried	活埋
Like Dandelion Dust	蒲公英的灰塵
Case 39	39號特案
Let Me In	噬血童話
The Social Network	社群網戰
Casino Jack	A金政客
It's Kind of a Funny Story	說來有點可笑
Life as We Know It	命中注定多個你
My Soul to Take	生日劊樂
Secretariat	奔騰人生
I Spit on Your Grave	我唾棄你的墳墓
Inside Job	幕後黑手
It's a Wonderful Afterlife	美好來生
The Elite Squad 2	精英部隊2：大敵當前
Stone	色獄心機
Tamara Drewe	塔瑪拉小姐
Jackass 3D	無厘取鬧3D
Red	超危險特工
Carlos	卡洛斯
Conviction	非常上訴
Hereafter	生死接觸
Paranormal Activity 2	鬼入鏡
Saw 3D	奪魂鋸3D
The Girl Who Kicked the Hornet's Nest	直搗蜂窩的女孩
Due Date	臨門湊一腳
For Colored Girls	有色女孩
Megamind	麥克邁：超能壞蛋
Fair Game	不公平的戰爭
Four Lions	四個傻瓜
127 Hours	127小時
Morning Glory	麻辣女強人
Skyline	天際浩劫
Unstoppable	煞不住
Harry Potter and the Deathly Hallows: Part 1	哈利波特：死神的聖物 I
The Next Three Days	關鍵救援72小時
Burlesque	舞孃俱樂部
Faster	限時絕殺
Love and Other Drugs	愛情藥不藥
Tangled	魔髮奇緣
The Nutcracker in 3D	魔境冒險3D
The King's Speech	王者之聲：宣戰時刻
The Warrior's Way	黃沙劍影
Night Catches Us	夜晚吞噬了我們
The Chronicles of Narnia: The Voyage of the Dawn Treader	納尼亞傳奇：黎明行者號
The Tourist	色遇
The Fighter	燃燒鬥魂
Frankie and Alice	法蘭基與艾莉絲
The Tempest	暴風雨
How Do You Know	愛在心裡怎知道
Tron: Legacy	創：光速戰記
Yogi Bear	瑜珈熊
Rabbit Hole	愛，讓悲傷終結
Little Fockers	門當父不對之我才是老大
True Grit	真實的勇氣
Somewhere	迷失某地
Gulliver's Travels	格列佛遊記
The Illusionist	魔術師
Another Year	又一年
Blue Valentine	藍色情人節
Biutiful	最後的美麗
Ballistic	彈道
Red Cliff 2	赤壁2:決戰天下
Bedtime Stories	天方夜談
The Chaser	追擊者
Yes Man	沒問題先生
No Regret	愛,不悔
Madagascar: Escape 2 Africa	馬達加斯加2
Life for Sale	人生,一元起標
Rabbit Without Ears	沒有耳朵的兔子
Revolutionary Road	真愛旅程
Storm Rider : Clash of Evils	風雲決
Milk	自由大道
Seven Pounds	七生有幸
Valkyrie	代號：華爾奇麗雅
100 Feet	顫慄100步
He's Just Not That Into You	他其實沒那麼喜歡妳
The Class	我和我的小鬼們
Ip Man	葉問
8 dates	來約會8
Curious Case of Benjamin Button	班傑明的奇幻旅程
Frost/Nixon	請問總統先生
：Marley & Me	馬利與我
Confessions of a Shopaholic	購物狂的異想世界
Waltz with Bashir	與巴席爾跳華爾滋
The Wrestler	力挽狂瀾
Slumdog Millionaire	貧民百萬富翁
Underworld: Rise of the Lycans	決戰異世界3
Friday The 13th	黑色星期五
Taken	即刻救援
Dragonball	七龍珠
Make It Happen	唯舞獨尊
Damage	烈火情人
The Pink Panther 2	粉紅豹2
Taare Zameen Par	心中的小星星
Step by Step	練戀舞
Nocturna	星星大作戰
A Frozen Flower	霜花店:朕的男人
Distant	遠方
Knowing	末日預言
Race to Witch Mountain	超異能冒險
Our Island our Dreams	星月無盡
Monsters vs. Aliens	怪獸大戰外星人
Fast and Furious	玩命關頭4
Fit Lover	愛情左右
Shinjuku Incident	新宿事件
Nomad: The Warrior	游牧英豪
Ghost Mother	守護靈
My Bloody Valentine 3-D	3D血腥情人節
Crank: High Voltage	快克殺手2
Killshot	生死一擊
Colorful mind	新魯冰花
Last Chance Harvey	愛,從心開始
The Horsemen	天啟四騎士
Whatever Lola Wants	玩美舞孃
Tokyo Sonata	東京奏鳴曲
I.O.U.S.A.	巴菲特報告
X-Men Origins: Wolverine	X戰警: 金鋼狼
Night at the Museum: Battle of the Smithsonian	博物館驚魂夜2
Terminator Salvation	魔鬼終結者4
17 Again	回到17歲
The Accidental Husband	我的意外老公
Angels &amp; Demons	天使與魔鬼
Money Not Enough 2	錢不夠用2
The Last House on the Left	左邊最後那棟房子
Dance Subaru	芭蕾少女
G.P. 506	惡靈碉堡
Revanche	維也納復仇
Amal	窮得只剩下錢
Splinter	異形魔種
Trail of the Panda	貓熊團圓路
Kung Fu Chefs	功夫廚神
The Great Match	決戰日
Family Rules	家有家規
Clara	琴戀克拉拉
O'Horten	霍頓的鐵道人生
Transformers: Revenge of the Fallen	變形金剛2
Nekonade	心動奇蹟2
The Taking of Pelham 1 2 3	亡命快劫
Cover boy	男色多瑙河
Ong bak 2	拳霸3
Duplicity	口是心非
Permanent Residence	永久居留
Ghosts of Girlfriends Past	舊愛找麻煩
Captain Abu Raed	愛無盡夢飛翔
You Will Be Mine	妳是我的蕾絲邊
Paris 36	放牛班快樂頌
I've Loved You So Long	我一直深愛著你
Ice Age: Dawn of the Dinosaurs	冰原歷險記3
Harry Potter and the Half-Blood Prince	哈利波特6:混血王子的背叛
Drag Me to Hell	地獄魔咒
Boy A	心靈鐵窗
Buppha Reborn	609
Pleasure Factory	快樂工廠
The Sniper	神鎗手
Tulpan	圖班嫁給我
Gu Gu the Cat	咕咕貓
How are you, Dad?	爸,你好嗎?
Grace is Gone	等媽媽回家的孩子
Oppai Volleyball	巨乳排球
Synecdoche, New York	紐約浮世繪
Gomorra	罪惡之城娥摩拉
Orphan	孤兒怨
Inglourious Basterds	惡棍特工
The Time Traveler's Wife	時空旅人之妻
Yang Yang	陽陽
My Sister's Keeper	姊姊的守護者
G-Force	鼠膽妙算
ROOKIES	菜鳥總動員電影版
Bruno	G型
Spread	情聖終結者
Coco Before Chanel	時尚女王香奈兒
Largo Winch	神鬼獵殺
No Puedo Viver Sin Ti	不能沒有你
Sex &amp; Chopsticks 2	金瓶梅2
Mediterranean Food	地中海廚娘
Baseballboys	野球孩子
The Proposal	愛情限時簽
Final Destination: Death Trip 3D	絕命終結站4
2:20	2分20秒
The Visitor	幸福來訪時
Bandslam	搖滾未來
Carriers	絕命帶原者
Virgin Snow	初雪之戀
Somewhere I Have never Travelled	帶我去遠方
The Rebound	愛情逆轉勝
Sorority Row	女生殺人宿舍
Overheard	竊聽風雲
I Hate Valentine's Day	我恨情人節
Amalfi: Rewards of the Goddess	女神的報酬
The Code	人體密碼
Murderer	殺人犯
Turtle: The Incredible Journey	在海裡飛翔
Franklyn	永恆之門
Youth Without Youth	第三朵玫瑰
Naoko	奈緒子
The September Issue	時尚惡魔的聖經
Kungfu Cyborg	機器俠
Goemon	大盜五右衛門
Astro Boy	原子小金剛
Saw VI	奪魂鋸6
Taking Woodstock	胡士托風波
Julie &amp; Julia	美味關係
Fame	名揚四海
Prince of Tears	淚王子
Tsunami	大浩劫
Skate or Die	絕命快閃
This Is It	未來的未來
Let the Right One In	血色入侵
A Perfect Getaway	蜜月變奏曲
The Message	風聲
Chef's Special	基佬大廚
Looking for Eric	尋找艾瑞克
The Lucky Ones	真情旅程
Coco Chanel &amp; Igor Stravinsky	香奈兒的秘密
Meat Grinder	人肉麵線
2012	2012
Ninja Assassin	忍者刺客
Disney's A Christmas Carol	聖誕夜怪譚
Antichrist	撒旦的情與慾
District 9	第九禁區
Bottle Shock	戀戀酒鄉
Le secret	賣百科全書的女人
Summer times	夏天協奏曲
The White Ribbon	白色緞帶
The Twilight Saga: New Moon	暮光之城2
Sherlock Holmes	福爾摩斯
Couples Retreat	伴侶渡假村
Buppha Revenge	609猛鬼終結者
The Storm Riders 2	風雲2
Bodyguards And Assassins	十月圍城
Treasure Hunter	刺陵
Troubled Water	心靈暗湧
Paranormal Activity	靈動:鬼影實錄
New York, I Love You	紐約我愛你
The Private Lives of Pippa Lee	她的私密日記
Transsiberian	消失的旅客
Tomorrow at Dawn	明天的黎明
Miss Kicki	霓虹心
The Other Man	外慾殺機
10,000 BC	史前一萬年
21	決勝21點
27 Dresses	27件禮服的祕密
88 Minutes	死亡倒數88分鐘
The Air I Breathe	交錯效應
Australia	澳大利亞
Stolperstein	絆腳石
Baby Mama	寶貝媽媽
Babylon A.D.	巴比倫密碼
The Bank Job	玩命追緝
Bangkok Dangerous	無聲火
Be Kind Rewind	王牌自拍秀
Beverly Hills Chihuahua	比佛利拜金狗
Big Stan	猛男姦獄
Blindness	盲流感
Body Of Lies	謊言對決
Bolt	雷霆戰狗
Brideshead Revisited	慾望莊園
Burn After Reading	即刻毀滅
Changeling	陌生的孩子
The Chronicles of Narnia: Prince Caspian	納尼亞傳奇：賈思潘王子
City of Ember	微光城市－黑暗之光首部曲
Cloverfield	柯洛弗檔案
College Road Trip	大學生了沒
The Curious Case of Benjamin Button	班傑明的奇幻旅程
The Dark Knight	黑暗騎士
The Day the Earth Stood Still	當地球停止轉動
Death Defying Acts	魔幻奇緣
Death Race	絕命尬車
Defiance	聖戰家園
Definitely, Maybe	愛情三選一
Deception	桃色名單
Doomsday	決戰末世代
Doubt	誘·惑
The Duchess	浮華一世情
Eagle Eye	鷹眼
Eden Lake	獵人遊戲
The Eye	變眼
Flashbacks of a Fool	舊愛，還是最美
Fool's Gold	傻愛成金
The Forbidden Kingdom	功夫之王
Funny Games	大劊人心
Get Smart	特務行不行
Happening	破天慌
Hancock	全民超人
Hannah Montana	孟漢娜3D立體演唱會
Hellboy II: The Golden Army	地獄怪客2：金甲軍團
Horton Hears a Who!	荷頓奇遇記
The House Bunny	女郎我最兔
High School Musical 3: Senior Year	歌舞青春3
In the Name of the King	末日危城：王者之役
Iron Man	鋼鐵人
The Incredible Hulk	無敵浩克
In Bruges	殺手沒有假期
Jumper	移動世界
Journey to the Center of the Earth	地心冒險
Kung Fu Panda	功夫熊貓
Lakeview Terrace	合法入侵
Leatherheads	愛情達陣
The Love Guru	愛情大師
Mad Money	有錢真好
Made of Honor	新郎不是我
Mamma Mia!	媽媽咪呀!
Man on Wire	偷天鋼索人
Marley &amp; Me	馬利與我
Max Payne	麥斯潘恩
Meet Dave	大衛特大號
Meet the Spartans	這不是斯巴達
Midnight Meat Train	午夜人肉列車
Mirrors	凶鏡
The Mummy: Tomb of the Dragon Emperor	神鬼傳奇3
My Best Friend's Girl	壞壞惹人愛
Nights in Rodanthe	羅丹薩的夜晚
Nim's Island	尼魔島
One Missed Call	鬼鈴聲
The Other Boleyn Girl	美人心機
Outlander	魔獸戰場
Paranoid Park	迷幻公園
Pathology	恐怖解剖室
Penelope	真愛之吻
Pride and Glory	非法警戒
Prom Night	舞夜驚魂
Quantum of Solace	007量子危機
Rambo	第一滴血4
The Reader	為愛朗讀
RocknRolla	搖滾黑幫
Run, Fat Boy, Run	求愛馬拉松
The Spiderwick Chronicles	奇幻精靈事件簿
Saw V	奪魂鋸5
Semi-Pro	灌籃大帝
Sex and the City	慾望城市
Shutter	鬼照片
Sorry if I love you	熟男我愛你
Speed Racer	駭速快手
Step Up 2 the Streets	舞力全開
The Strangers	陌路狂殺
Street Kings	正義悍將
Superhero Movie	又一部超人電影
Tinker Bell	奇妙仙子
Tropic Thunder	開麥拉驚魂
Untraceable	Live殺人網站
Vantage Point	刺殺據點
W.	小布希傳
Wall-E	瓦力
Wanted	刺客聯盟
War, Inc.	戰爭製造公司
Water Lilies	愛上壞女孩
Welcome Home Roscoe Jenkins	怪咖一家親
What Happens in Vegas	頭彩冤家
What Just Happened?	顛覆瘋雲
The Women	女人至上
X-Files: I Want to Believe	X檔案：我要相信
XXY	我是女生，也是男生
You Don't Mess with the Zohan	特勤沙龍
Zack and Miri Make a Porno	淫幕初體驗
