The Ten	哈啦十誡
Pride	同志驕傲大遊行
Gifted	天才的禮物
You're Next	下一秒就是你
Humpday	G片初體驗
Adam	亞當不好當
Genius	天才柏金斯
The Hateful Eight	八
One Last Thing...	最後的願望
Modigliani	燃情狂愛
Trainwreck	肉食女之戀
Match Point	愛情決勝點
Annie	安妮
Sicko	健保真要命
The Perfect Guy	完美情狼
Hector and the search for happiness	尋找快樂的15種方法
Derailed	玩火
Coco	可可夜總會
Oslo, 31. august	八月三十一日,我在奧斯陸
The Notorious Bettie Page	寫真女王
Shooter	狙擊生死線
Georgia Rule	情規喬治亞
Black Souls	教父啟示錄
Must Love Dogs	愛狗男人請來電
Alvin and the Chipmunks	鼠來寶
Mr. Holmes	福爾摩斯先生
Sydney White	白雪新鮮人
Gangster Squad	風雲男人幫
Cloudy With a Chance of Meatballs 2	食破天驚2
Win Win	幸福雙贏
The Mummy: Tomb of the Dragon Emperor	神鬼傳奇3
On a Clear Day	澄澈的一天
Texas Killing Fields	德州棄屍現場
The Promotion	職場爭霸戰
Inherent Vice	性本惡
Pacific Rim: Uprising	環太平洋2
The Grey	即刻獵殺
Eagle Eye	鷹眼
Nebraska	內布拉斯加
The Beaver	海狸先生
The Wild	野蠻任務
Hotel for Dogs	狗狗旅館
The 40-Year-Old Virgin	40處男
A Good Old Fashioned Orgy	雜交有益身心
Letters to Father Jacob	給雅各神父的信
Why Him?	惱爸偏頭痛
August	八月錢潮
War Machine	戰爭機器
The Last Exorcism Part II	最後大法師2
Cheaper by the Dozen 2	二十四笑
Machuca	那年陽光燦爛
On the Road	浪蕩世代
Dark Skies	幽浮檔案
The LEGO Movie	樂高玩電影
Double Trouble	寶島雙雄
Branded	莫斯科2017
White God	忠犬追殺令
The World's End	末日
Pawn Sacrifice	出棋制勝
The Amazing Spider-Man	蜘蛛人:驚奇再起
Ouija	碟仙
Yes	黎巴嫩情人
Cloud Atlas	雲圖
American Pastoral	美國心風暴
Resident Evil: Afterlife	惡靈古堡4
Munich	慕尼黑
Peter Rabbit	得兔
Angry Birds	憤怒鳥
Lights in the Dusk	薄暮之光
The Cave	異底洞
Step Up 3D	舞力全開3D
Trick 'r Treat	不給糖就殺人
Grudge Match	進擊的大佬
Maze Runner: The Death Cure	移動迷宮3
Hamlet 2	哈姆雷特2
The Skeleton Key	毒鑰
Beauty Shop	哈啦美髮師
Collide	玩命撞擊
Mister Foe	在屋頂上流浪
The Gallows	絞刑台
The Fourth Kind	第四類接觸
Isle of Dogs	犬之島
Battle of the Year	世界Battle
The Tree of Life	永生樹
Duck Season	友情電力公司
Are We There Yet?	小鬼上路
What Doesn't Kill You	好漢不死
Disney's A Christmas Carol	聖誕夜怪譚
Jeepers Creepers 3: Cathedral	毛骨悚然3
Power Rangers	金剛戰士
Mission: Impossible 3	不可能的任務3
Ballerina	芭蕾奇緣
The Hunting Party	腥聞
The Losers	敗者為王
A Guide to Recognizing Your Saints	放下屠刀
The Host	宿主
Mark Felt: The Man Who Brought Down the White House	推倒白宮的男人
Bandslam	搖滾未來
Personal Shopper	私人採購
Enron: The Smartest Guys in the Room	安隆風暴
Unbroken	永不屈服
The Longest Yard	鐵男橄欖球
Return to Sender	控制遊戲
Where the Truth Lies	真相何在
Spy Kids: All the Time in the World	小鬼大間諜4
13 Hours: The Secret Soldiers of Benghazi	13小時
Wrath of the Titans	超世紀封神榜2
Special ID	特殊身份
The Woman in Black: Angel of Death	顫慄黑影2
The Green Hornet	青蜂俠
Captivity	窒命寫真
Cashback	超級賣場
Ice Princess	冰公主
Paris	巴黎愛情故事
The Maze Runner: The Scorch Trials	移動迷宮2:焦土試煉
The Dark Is Rising	黑紀元
Breathe	我要為你呼吸
Resident Evil: The Final Chapter	惡靈古堡6
Love in the Time of Cholera	愛在瘟疫蔓延時
活見鬼	活見鬼
The Blind Side	攻其不備
Wonder	奇蹟男孩
Running With Scissors	剪刀邊緣
Money Monster	金錢怪獸
Tucker & Dale vs. Evil	大學生殺了沒
New York, I Love You	紐約我愛你
The Rocker	搖滾青春夢
The Collector	蒐藏人
Sing Street	搖滾青春戀習曲
High School Musical 3: Senior Year	歌舞青春3
The Tribe	過於寂靜的喧囂
21	決勝21點
Into the Wild	阿拉斯加之死
Planes	飛機總動員
The Hunger Games: Catching Fire	飢餓遊戲2
Red Sparrow	紅雀
Filth	下流刑警
Non-Stop	空中救援
Little White Lies	愛謎藏
Creed	金牌拳手
Two Night Stand	暴雪二夜情
Fame	名揚四海
Standing Still	明天也要作伴
The Great Beauty	絕美之城
A Very Harold & Kumar Christmas	豬頭漢堡飽3D
Transporter 2	玩命快遞2
Shoot 'Em Up	火線保鑣
Get Rich or Die Tryin'	要錢不要命
The Departed	神鬼無間
Hannah Montana The Movie	孟漢娜電影版
Wolves	狼人鎮
The Oh in Ohio	俄亥俄的哦
Winchester	溫徹斯特鬼屋
Akeelah and the Bee	拼出新世界
Outsourced	世界是平的
Kung Fu Panda 2	功夫熊貓2
Black Swan	黑天鵝
The Grand Seduction	誘惑醫生100招
Sherlock Holmes 2	福爾摩斯2
Shrek the Third	史瑞克三世
The East	東方聯盟
House of Wax	恐佈蠟像館
Simon Killer	巴黎自由行
Reno 911!: Miami	邁阿密瘋雲
Apartment 143	鬼寓143
Vacancy	針孔旅社
Snow White and the Huntsman	公主與狩獵者
The Family Stone	婆家就是你家
Eden Lake	獵人遊戲
Into the Fire	風暴過後
The Witch	巫氣逼人
Crash	衝擊效應
Rams	羊男的冰島冒險
Ice Age: Collision Course	冰原歷險記5
The Kings of Summer	夏日之王
Ninja Turtles	忍者龜
Beasts of the Southern Wild	南方野獸樂園
The Queen	女王陛下
Saint Ralph	神奇馬拉松
Fred Claus	聖誕
Le Havre	溫心港灣
Hannah Montana & Miley Cyrus: Best of Both Worlds Concert Tour	孟漢娜3D演唱會
Passengers	星際過客
The Mechanic	極速秒殺
Thor: Ragnarok	雷神索爾3
The Amateurs	A片特攻隊
Elysium	極樂世界
National Treasure 2	國家寶藏2
1408	1408
Bobby	五星級謀殺
Toy Story 3	玩具總動員3
Daddy's Home 2	家有兩個爸2
Imaginary Heroes	心碎天堂
Rise of the Guardians	捍衛聯盟
X戰警: 未來昔日	X戰警:未來昔日
Slow West	槍響前決定愛不愛你
The Company You Keep	夥伴
Prom	畢業舞會
Conan the Barbarian	王者之劍3D
Tony Takitani	東尼瀧谷
Happy Feet Two	快樂腳2
Call Me by Your Name	以你的名字呼喚我
50/50	活個痛快
1911	1911辛亥革命
Daltry Calhoun	草地上的男人
I Spit on Your Grave	我唾棄你的墳墓
The Beautiful Country	美麗新故鄉
Meet the Robinsons	未來小子
Jupiter Ascending	朱比特崛起
Remember	我記得
Knowing	末日預言
Boy A	頭號男孩
Zero Dark Thirty	0501斬首密令
Cheap Thrills	絕命賭局
Ghostbusters	魔鬼剋星
An Unfinished Life	待續
Pitch Perfect 2	歌喉讚2
Ip Man 2	葉問2
The Odd Life of Timothy Green	小芽的奇幻人生
Funny Games	大快人心
Collateral Beauty	最美的安排
Promised Land	心靈
Bright	光靈
Blood and Chocolate	血腥巧克力
Irina Palm	洞裡春光
Morgan	魔詭
Quartet	唱快人生
What Just Happened?	顛覆瘋雲
Breaking & Entering	非法入侵
Monte Carlo	愛在蒙地卡羅
Frantz	雙面法蘭茲
Letters from Iwo Jima	來自硫磺島的信
Kung Fu Hustle	功夫
Free State of Jones	烈火邊境
Nymphomaniac	性愛成癮的女人
Snowpiercer	末日列車
Miss Peregrine's Home for Peculiar Children	怪奇孤兒院
The Guilt Trip	虎媽宅子
American Ultra	廢柴特務
Coco Before Chanel	時尚女王香奈兒
An Inconvenient Sequel: Truth to Power	不願面對的真相2
The World's Fastest Indian	超速先生
Pixels	世界大對戰
Sex Drive	性愛之旅
Interstellar	星際
Moneyball	魔球
Sin City	萬惡城市
Mirrors	鬼鏡西洋版
Che	切
3 Needles	帶原者之歌
Len and Company	搖滾不靠爸
Tomorrowland	明日世界
John Carter	異星戰場
The Long Weekend	哥哥我還要
The Gospel	福音總動員
Texas Chainsaw Massacre 3D	德州電鋸殺人狂3D
Minions	小小兵
Over Her Dead Body	我男友的死未婚妻
The Diving Bell and the Butterfly	潛水鐘與蝴蝶
Blended	當我們混在一起
45 Years	45年
The Florida Project	歡迎光臨奇幻城堡
Paranoid Park	迷幻公園
For a Good Time, Call...	高潮專線
The Choice	抉擇
Zero Days	零日網路戰
Snakes on a Plane	飛機上有蛇
Bourne 5	神鬼認證5
Heaven Is for Real	看見天堂
Are You Here	人生大逆轉
Feast of Love	愛情盛宴
The Purge: Election Year	國定殺戮日3
Terminator Salvation	魔鬼終結者4
Black Christmas	絕命聖誕
Killers	刺客公敵
Borat	芭樂特
A Quiet Place	噤界
Think Like a Man	男人的上半身去哪了
Black Book	黑書
Voice from the Stone	謎之陰
Loverboy	溺愛
Fun with Dick and Jane	我愛上流
Tammy	阿美闖天涯
People Like Us	親情可貴
Breakfast on Pluto	冥王星早餐
Tamara	魔女煞
Outlander	魔獸戰場
Marguerite	巴黎走音天后
The Hobbit: An Unexpected Journey	哈比人
The Age of Adaline	時空永恆的愛戀
December Boys	十二月的男孩
The Astronaut Farmer	太空農夫
The Expendables 2	浴血任務2
Dunkirk	敦克爾克大行動
The Railway Man	心靈勇者
Alexander and the Terrible, Horrible, No Good, Very Bad Day	亞歷山大衰到家
Sisters	瞎趴姊妹
Code Name: The Cleaner	霹靂鳥探
The Neon Demon	霓虹惡魔
The Salt of the Earth	薩爾加多的凝視
Moana	海洋奇緣
The U.S. vs. John Lennon	美國vs.約翰藍儂
Paddington	熊愛趴趴走
The SpongeBob Movie: Sponge Out of Water	海綿寶寶2
21 Jump Street	龍虎少年隊
Detachment	人間師格
[REC] 3: Genesis	錄到鬼3
High Tension	顫慄
Cinderella Man	最後一擊
Bandidas	神鬼二勢力
Short Term 12	她和她的小鬼們
The Space Between Us	我們之間的小宇宙
Sabotage	震撼殺戮
The Stone Angel	天使石像
Chappie	成人世界
Another Gay Movie	酷兒狂歡派
Middle Men	中間人
Water	禍水
Grand Piano	關鍵琴聲
Fences	籬笆內的風暴
Smashed	醉生夢醒
The Silence of Lorna	沉默的羅娜
Rio 2	里約大冒險2
X-Men: First Class	X戰警:第一課
Divergent	分歧者2
Ponyo on the Cliff	崖上的波妞
Detroit	底特律
Courageous	勇氣之名
Fido	我家有個大屍兄
Gerald's Game	傑羅德遊戲
One Chance	翻聲吧保羅
Early Man	石器小英雄
Bridesmaids	伴娘幫幫忙
Happy Death Day	忌日快樂
Monsieur Lazhar	再見了,拉札老師
Reprise	愛重奏
Five Star Day	占星奇緣
Take Me Home Tonight	今晚帶我回家
Mother!	母親!
Tyler Perry's Madea's Family Reunion	家和萬事興
The Monuments Men	大尋寶家
Hoot	夏日鴞鳴
Remember Me	記得我
Saw IV	奪魂鋸4
Finding Dory	海底總動員2
Shortbus	性愛巴士
War of the Worlds	世界大戰
Clouds of Sils Maria	星光雲寂
Whiskey Tango Foxtrot	戰地瘋雲
Haven	染血天堂
Kon-Tiki	康提基號
Phantom Thread	霓裳魅影
Our Time Will Come	明月幾時有
Scary Movie 4	驚聲尖笑4
Renaissance	黑暗文藝復興
Mongol	蒙古王
Unlocked	全面封鎖
Beverly Hills Chihuahua	比佛利拜金狗
Wild Card	拳力突襲
Free Fire	玩命鎗火
The Glass Castle	玻璃城堡
Only the Brave	無路可退
I Hope They Serve Beer in Hell	塔克,嘿咻嘿咻嘿咻!
The Greatest Showman	大娛樂家
CARS 3	汽車總動員3
Zoom	超人集中營
Knock Knock	當辣妹來敲門
ParaNorman	派拉諾曼:靈動小子
Looking for Eric	尋找艾瑞克
Suburbicon	完美社區謀殺案
Jurassic World: Fallen Kingdom	侏羅紀世界2
Cosmopolis	夢遊大都會
The Layover	獵男有轉機
Timbuktu	在地圖結束的地方
Insidious Chapter 3	陰兒房3
The Huntsman Winter’s War	狩獵者:凜冬之戰
Capital	資本遊戲
Cirque du Soleil: Worlds Away 3D	太陽馬戲團
Monster-in-Law	野獸婆婆
The Fighter	燃燒鬥魂
While We're Young	青春倒退嚕
Stop-Loss	拒絕再戰
Harry Potter and the Order of the Phoenix	哈利波特6
Or	後街天使
Drive Angry 3D	3D怒火狂飆
Underworld: Blood Wars	決戰異世界5
Free the Nipple	Lady's尖頭們
Don't Come Knocking	別來敲門
Ong-Bak: The Thai Warrior	拳霸
Jeff, Who Lives at Home	阿宅的二三事
Joe	叢林法則
Leaves of Grass	雙子陰謀
Boogeyman	惡靈空間
Diana	黛安娜
The Ex	舊情人
Persepolis	茉莉人生
The Brothers Grimm	神鬼剋星
Sanctum	3D驚天洞地
Robin Hood	羅賓漢
How to Eat Fried Worms	活蟲生吃
Greenberg	愛上草食男
Layer Cake	夾心蛋糕
Alice Through the Looking Glass	魔境夢遊2
Playing for Keeps	情場大玩咖
All Good Things	好景不常
Failure to Launch	賴家王老五
Street Fighter: The Legend of Chun-Li	春麗傳奇
The Quiet Ones	檔案
The Big Wedding	婚禮大聯矇
Mao's Last Dancer	毛的最後舞者
10 Years	十年
Son of Saul	索爾之子
Abraham Lincoln: Vampire Hunter	吸血鬼獵人
Anomalisa	安諾瑪麗莎
Three Billboards Outside Ebbing, Missouri	意外
Mission: Impossible 5	不可能的任務5
12	12怒漢:大審叛
Nothing But the Truth	捍衛真相
Intruders	入侵者
Twelve	花邊藥頭
Rock School	搖滾學校
A Million Ways to Die in the West	百萬種硬的方式
A Fantastic Woman	不思議女人
Crazy Heart	瘋狂之心
A Beautiful Life	不再讓你孤單
License to Wed	結婚糾察隊
Tideland	奇幻世界
Billy Lynn’s Long Halftime walk	比利林恩
It's Kind of a Funny Story	說來有點可笑
I Love You, Man	麻吉伴郎
A History of Violence	暴力
School for Scoundrels	無賴速成班
The Protector	拳霸2
Coraline	第十四道門
[Rec] 2	屍控
Standing Tall	烈焰青春
Taxi to the Dark Side	計程車司機之死
The Twilight Saga: Eclipse	暮光之城3
God Help the Girl	戀夏小情歌
The Jacket	戰慄時空
The Trip to Italy	同遊義大利
Book of Life	曼羅奇遇記
A Cure For Wellness	救命解藥
Green Lantern	綠光戰警
Lost in Hong Kong	港囧
Good Night. And, Good Luck	晚安!祝你好運
Midnight in Paris	午夜巴黎
Grizzly Man	灰熊人
From Mexico with Love	拳頭生涯原是夢
Welcome to the Punch	重擊戒備
The Haunting in Connecticut 2: Ghosts of Georgia	康乃狄克鬼屋事件2
Miss You Already	已經很想妳
GF。BF	女朋友男朋友
Bucky Larson: Born to be a Star	天生男優
The Other Guys	B咖戰警
We Need to Talk About Kevin	凱文怎麼了
Storks	送子鳥
Trust	迷網女孩
Star Trek Sequel	星際爭霸戰2
Flushed Away	鼠國流浪記
Dallas 362	達拉斯362
Life As We Know It	命中注定多個你
3 Days to Kill	特務殺很大
Yogi Bear	瑜珈熊
Elizabeth: The Golden Age	輝煌年代
The Clan	大犯罪家
Jackass 3D	無厘取鬧3D
Shooting Dogs	殺戮禁區
Freeheld	扣押幸福
Point Blank	活命條件
Don't Be Afraid of the Dark	別怕黑
The Good Night	夜夜成癮的男人
Billy Lynn’s Long Halftime walk	的中場戰事
Undiscovered	緣星夢
Ghost in the Shell	攻殼機動隊
The Dressmaker	惡女訂製服
21 and Over	醉後大學生
Dead And Breakfast	誰敢來早餐
Murder on the Orient Express	東方快車謀殺案
The Hottie & the Nottie	愛上野豬妹
House At The End of the Street	末路凶宅
Rabbit Hole	愛,讓悲傷終結
The Celestine Prophecy	聖境預言書
Juno	鴻孕當頭
Maniac	剝頭煞星
Last Holiday	假期
Me and Earl and the Dying Girl	我們的故事未完待續
Captain America 3: Civil War	美國隊長3
Then She Found Me	心的歸屬
Learning to Drive	愛情停看聽
Mission: Impossible Ghost Protocol	不可能的任務4
Guess Who	誰敢來晚餐
Howl	嚎囂
The Sisterhood of the Traveling Pants	牛仔褲的夏天
My Life in Ruins	旅行的意義
Mysterious Skin	神秘肌膚
Happy Feet	快樂腳
Carnage	今晚誰當家
Diary of a Wimpy Kid: Dog Days	遜咖冒險王3
Dead Snow 2: Red vs. Dead	冰血奇緣
Our Brand Is Crisis	危機
The Child	孩子
The Mummy	神鬼傳奇
Henry Poole is Here	上帝在我家
Priceless	巴黎拜金女
The X Files 2	X檔案2
The Brothers Solomon	情聖兄弟
The Man Who Knew Infinity	天才無限家
The Gambler	玩命賭徒
Lady in the Water	水中的女人
Hidden	隱藏攝影機
Palo Alto	高校寫真
Assault on Precinct 13	殲滅十三區
Wonder Wheel	愛情摩天輪
Streets of Legend	黑街神話
The Space Between Us	愛上火星男孩
Jurassic World	侏羅紀世界
The Bye Bye Man	冤親債主
Stoker	慾謀
The Pacifier	限制級褓母
I Saw the Light	音樂之光
Pride	榮耀泳隊
Masterminds	笨賊樂盜家
Mamma Mia!	媽媽咪呀!
Due Date	臨門湊一腳
Taking Woodstock	胡士托風波
The Missing Picture	遺失的映像
Thor: The Dark World	雷神索爾2
Priest	獵魔教士
Shrek Forever After	史瑞克四
The Memory of a Killer	殺手輓歌
Deuce Bigalow: European Gigolo	哈啦猛男秀2
Blue Valentine	藍色情人節
Chef	五星主廚快餐車
Out of the Furnace	逃出熔爐
600 Millas	命懸六百哩
Everybody Wants to Be Italian	義國戀
Run, Fat Boy, Run	求愛馬拉松
Slender Man	妖瘦男
My Little Pony: The Movie	彩虹小馬大電影
Same Kind of Different as Me	紳士與流浪漢
Le Week-End	愛在巴黎破曉時
Alvin and the Chipmunks - Chipwrecked	鼠來寶3
Off the Map	世界盡頭
Just Like Heaven	出竅情人
Leatherheads	愛情達陣
Ninja Assassin	忍者刺客
George A. Romero's Land of the Dead	活屍禁區
MirrorMask	仙鏡奇緣
The Secret Life of Bees	蜂蜜罐上的聖瑪利
Nurse 3D	3D血護士
Mr. Magorium's Wonder Emporium	魔法玩具城
Journey 3-D	3D地心冒險
The Other Side of Hope	希望在世界另一端
Peanuts	史努比
Miracle at St. Anna	聖安娜奇蹟
The Fog	鬼霧
The Perfect Man	尋找阿娜答
Julie & Julia	美味關係
The Disaster Artist	大災難家
Lords of Dogtown	衝破顛峰
Frankenweenie	科學怪犬
The Producers	金牌製作人
The Adventurers	俠盜聯盟
Dolphin Tale	重返海豚灣
Ceremony	劫婚典禮
Primeval	萬鱷巨獸
Joshua	魔鬼約書亞
The Zero Theorem	明日定律
The Spy Next Door	鄰家特務
Seeking Justice	私法正義
The Secret Life of Walter Mitty	白日夢冒險王
Millions	百萬小富翁
Memories of Tomorrow	明日的記憶
The Painted Veil	猜心
Fruitvale Station	奧斯卡的一天
Self/less	換命法則
Goal! The Dream Begins	疾風禁區
Dheepan	流離者之歌
Big Eyes	大眼睛
Prince of Persia: The Sands of Time	波斯王子
Marley & Me	馬利與我
The Divergent Series: Allegiant	赤誠者
Run the Tide	逐浪而生
The Game of Their Lives	贏向一生的挑戰
Stephen King's The Mist	迷霧驚魂
Frost/Nixon	請問總統先生
Monsters vs. Aliens	怪獸大戰外星人
A Long Way Down	往下跳
Puncture	針情法網
Jack Reacher 2	神隱任務2
Diminished Capacity	往事隨風
Five Minutes of Heaven	天堂五分鐘
Paper Towns	紙上城市
The Last Five Years	最後那五年
Smile	笑逐顏開
Scream 4	驚聲尖叫4
The Illusionist	魔術師
The Killer Inside Me	魔由心生
The Zookeeper's Wife	園長夫人:動物園的奇蹟
Everything Must Go	一無所有
Something in the air	五月風暴
Foxcatcher	狐狸捕手
Fast Five	玩命關頭5
A Sound of Thunder	雷霆萬鈞
What Maisie Knew	梅西的世界
The Women	女人至上
The Twilight Saga: Breaking Dawn - Part 2	暮光之城4:破曉Ⅱ
Oliver Twist	孤雛淚
Red 2	超危險特工2
The Girl on the Train	列車上的女孩
I Love You, Beth Cooper	我愛你
Alex Cross	絕命追緝令
愛在愛情空窗期	愛在愛情空窗期
Happy-Go-Lucky	樂觀以對
Soul Men	靈魂樂手
The Road	往生路
Jack the Giant Killer	傑克巨人戰記
Don't Tell	誘禍
Coco Chanel & Igor Stravinsky	香奈兒的秘密
Collide	偷天劫車手
Ask the Dust	心塵情緣
Renegades	潛龍突擊隊
The Flowers of War	金陵十三釵
No Strings Attached	飯飯之交
Stolen	盜數計時
Time	謊顏
Saw V	奪魂鋸5
Good Kill	狙擊手
Holding Trevor	誰來愛我
Declaration of War	親愛的別哭
Percy Jackson: Sea of Monsters	波西傑克森2
That Awkward Moment	我們算正式交往嗎？
The Best Offer	寂寞拍賣師
Fast Food Nation	速食國度
Music Within	樂自心中來
Chocolate	致命巧克力
Pirates of the Caribbean: Dead Man's Chest	神鬼奇航2
RV	休旅任務
Thanks for Sharing	謝謝分享,我的愛
Off the Black	賠我走這一程
Thumbsucker	吮指
Star Wars: Episode VIII: Space Bear	星際大戰8
Ip Man 3	葉問3
Beauty and the Beast	美女與野獸
Camp X-Ray	關塔那摩X光營
Eastern Promises	巨塔殺機
Milk	自由大道
Concussion	震盪
Linsanity	林來瘋
Insidious Chapter 2	陰兒房2
Mad Hot Ballroom	快樂舞年級
Tales from Earthsea	地海戰記
Madagascar 3: Europe's Most Wanted	馬達加斯加3
Angels & Demons	天使與魔鬼
American Honey	2016美國甜心
Carrie	魔女嘉莉
Passengers	靈異航班
Headhunters	獵頭遊戲
Angel	逐愛天堂
Kick-Ass 2	特攻聯盟2
The Assassination of Jesse James by the Coward Robert Ford	刺殺傑西
Stranger by the Lake	湖畔春光
Dolphin Tale 2	溫特的故事2
Smallfoot	小腳怪
Fugitive Pieces	心碎時光
The Smurfs	藍色小精靈
College	大學預備生
Hellboy 2	地獄怪客2
Town Creek	鬼哭人嚎
Summer Hours	夏日時光
Lion	漫漫回家路
Spare Parts	夢想啟動
After the Wedding	婚禮之後
Arctic Tale	極地熊寶貝
Friend Request	非死不可
Stung	蜂狂
Dedication	插畫情緣
Vita Activa: The Spirit of Hannah Arendt	─思想的行動
The Pirates! Band of Misfits	海賊天團
The Time Traveler's Wife	時空旅人之妻
The Void	恐懼虛空
Spotlight	驚爆焦點
I'll Follow You Down	時空效應
Tokyo Sonata	東京奏鳴曲
Blair Witch	厄夜叢林3
The Big Year	賞鳥的一年
Crossing Over	嫁禍手段
Barnyard	瘋狂農莊
The Good Shepherd	特務風雲
Vacation	全家玩到趴
Meet Dave	大衛特大號
Lost in Thailand	人再囧途之泰囧
The Paperboy	臨時派報員
From Prada To Nada	小姐好窮
Paranormal Activity 4	鬼入鏡4
She's Out of My League	辣妹愛宅男
The Game Plan	超級盃奶爸
Home of the Brave	勇士之家
Night at the Museum: Battle of the Smithsonian	博物館驚魂夜2
Elite Squad	精銳部隊
Requiem	靈界線
Big Game	總統遊戲
The Green Prince	哈瑪斯之子
About Ray	幸福不設限
Legend	金牌黑幫
Drive	落日車神
Dr. Seuss' The Lorax	羅雷司
The Orphanage	靈異孤兒院
Marilyn Hotchkiss' Ballroom Dancing and Charm School	舞動心方向
Vita Activa: The Spirit of Hannah Arendt	漢娜鄂蘭
Fever Pitch	愛情全壘打
The Change-Up	玩咖尬宅爸
August Rush	貝伍夫:把愛找回來
Margot at the Wedding	婚禮的祝福
Megamind	麥克邁:超能壞蛋
Monsters University	怪獸大學
Before I Wake	鬼撕眠
King Cobra	眼鏡蛇男神
Wish I Was Here	白日夢孩子王
The Tempest	暴風雨
Sin City: A Dame to Kill For	萬惡城市2
Miss Meadows	甜心殺手
Night at the Museum 3	博物館驚魂夜3
Zoolander 2	名模大間諜2
Attack the Block	異星大作戰
Aquamarine	美人魚之戀
Pride and Prejudice and Zombies	傲慢與偏見與殭屍
The New World	決戰新世界
Katy Perry: Part of Me	凱蒂佩芮:做我自己
In the Name of the King: A Dungeon Siege Tale	末日危城
Wallace & Gromit - The Curse of the Were-Rabbit	酷狗寶貝
Everest	聖母峰
Burn After Reading	即刻毀滅
Lucy	露西
Central Intelligence	中央情報局
Bangkok Dangerous	無聲火
There Will Be Blood	黑金企業
Brokeback Mountain	斷背山
Kindergarten Cop 2	魔鬼孩子王2
Robots	機器人歷險記
Precious: Based on the Novel "Push" by Sapphire	珍愛人生
White House Down	白宮末日
The Lost City of Z	失落之城
American Sniper	美國狙擊手
Proof	證明我愛你
2016: Obama's America	2016:歐巴馬的美國
Madagascar	馬達加斯加
Death of a Superhero	愛情超能量
John Rabe	拉貝日記
The Disappointments Room	鬼開門
Maps to the Stars	寂寞星圖
Killing Them Softly	殺戮行動
The Monkey King 2	西遊記之孫悟空三打白骨精
The Man From U.N.C.L.E.	紳士密令
Black Snake Moan	花痴
Love & Friendship	蘇珊夫人尋婚計
We are What we are	屍房宴
Factotum	醉快活
Suffragette	女權之聲:無懼年代
Balzac and the Little Chinese Seamstress	巴爾札克與小裁縫
The Night Listener	頻率
CJ7	長江七號
Hot Tub Time Machine	扭轉時光機
The Lucky One	幸運符
The Hitman’s Bodyguard	殺手保鑣
The Preppie Connection	玩酷壞痞子
The Iron Lady	鐵娘子
All I See Is You	盲女驚心
Annabelle	安娜貝爾
Chicken Little	四眼天雞
Before Midnight	愛在午夜希臘時
Iron Man 3	鋼鐵人3
Happy People: A Year in the Taiga	西伯利亞漂流
Sex and the City 2	慾望城市2
The Best Man Holiday	哈拉婚禮2
The Good Dinosaur	恐龍當家
Waiting for Forever	等妳到永遠
A Monster Calls	怪物來敲門
Baahubali: The Beginning	帝國戰神
The Conspirator	刺客共犯
The To Do List	大學生做了沒
Ma Mere	母親,愛情的限度
Broken Embraces	破碎的擁抱
Stand Up Guys	重振雄風
No One Lives	無人生還
The Man	硬漢教育
Valiant	鴿戰
Mr. Bean's Holiday	豆豆假期
The Chumscrubber	我行我素
That's My Boy	我老爸卡好
Avengers: Age of Ultron	復仇者聯盟2
Rampart	壁壘分局
Hail, Caesar!	凱薩萬歲
Bachelorette	單身女郎派對
42	傳奇42號
21 Jump Street 2	龍虎少年隊2
The Grand Budapest Hotel	布達佩斯大飯店
The White Ribbon	白色緞帶
My Blueberry Nights	我的藍莓夜
Mars Needs Moms	火星救母記
Fury	怒火特攻隊
Anna Karenina	安娜卡列妮娜
Taken 3	即刻救援3
Death Wish	猛龍怪客
Sound of Noise	噪反城市
American Reunion	美國派:高潮再起
Curse of the Golden Flower	滿城盡帶黃金甲
The Post	郵報:密戰
The Emoji Movie	表情符號電影
She’s funny that way	百老匯風流記
Broken Flowers	心碎排行榜
Eagle vs. Shark	鯊魚愛老鷹
Smurfs: The Lost Village	藍色小精靈3
Resurrecting the Champ	重振聲威
Tooth Fairy	牙仙大帝
Transformers 4	變形金剛4
Despicable Me	神偷奶爸
The Passionate Life of Edith Piaf	玫瑰人生
Blackway	反擊
Tales of Halloween	萬聖夜怪譚
Louder Than Bombs	記憶乍響
Summer Palace	頤和園
Piranha 3DD	3DD食人魚
Brick Mansions	玩命特區
The Angels' Share	天使威士忌
The Amazing Spider-Man 2	蜘蛛人
This Film is Not Yet Rated	本片尚未分級
The Darkest Hour	黑暗時刻
Knocked Up	好孕臨門
Hours	搏命關頭
Bratz	閃亮小天后
Undead	獵殺活死人
Hansel and Gretel: Witch Hunters	女巫獵人
Predestination	超時空攔截
The Mountain Between Us	絕處逢山
Bee Season	蜂王季
The Model	時尚帝國合約的開始
Bernie	胖尼殺很大
The Taking of Pelham 1 2 3	亡命快劫
The Wolf of Wall Street	華爾街之狼
True Legend	蘇乞兒
Poison Friends	解構新鮮人
Incendies	烈火焚身
Nocturnal Animals	夜行動物
The warloads	投名狀
A Lot Like Love	再見鍾情
The Hottest State	最炎熱的州
In a Better World	更好的世界
Mrs. Henderson Presents	裸體舞台
The Drop	錢藏凶機
My Brother Is An Only Child	我的左派哥哥
Fur	皮相獵人
The Wind Rises	風起
child 44	第44個孩子
Open Season	打獵季節
Jackass 2	蠢蛋搞怪秀2
The Details	居家風暴
Centurion	世紀戰魂
Let Me In	噬血童話
Saw: Legacy	奪魂鋸8
Finding Vivian Maier	尋秘街拍客
Philomena	遲來的
Rush Hour 3	尖峰時刻3
Inglourious Basterds	惡棍特工
Big Ass Spider	屁王蜘蛛
Ricki and the Flash	搖滾女王
Cold Souls	靈魂冷凍庫
Twenty Feet from Stardom	伴唱人生
Star Wars: Episode I The Phantom Menace 3D	星際大戰:威脅潛伏3D
Berlin Syndrome	顫慄柏林
Three Monkeys	三隻猴子
Clash of the Titans	超世紀封神榜
Rogue One: A Star Wars Story	星際大戰外傳:俠盜一號
Shut In	育陰房
Sicario 2: Soldado	怒火邊界2
Easy A	破處女王
I, Tonya	老娘叫譚雅
Man of Tai Chi	太極俠
Horrible Bosses	老闆不是人
Wild Tales	生命中最抓狂的小事
Horns	魔角
A Separation	分居風暴
13 Tzameti	百萬殺人遊戲
All About Steve	求愛女王
88 Minutes	八十八分鐘
Blue Jasmine	藍色茉莉
Allied	同盟鶼鰈
9 Songs	性愛搖滾樂
Doom	毀滅戰士
We Own the Night	萬惡夜總會
47 Ronin	浪人47
Here Comes the Boom	肉腳擂台
The Twilight Saga: Breaking Dawn - Part 1	暮光之城4:破曉I
Paradise Lost	失樂園
Mistress America	美國小三
Dangal	我和我的冠軍女兒
Election 2	黑社會2
Glee: The 3D Concert Movie	歡樂合唱團3D
H2	月光光心慌慌2
Basic Instinct 2: Risk Addiction	第六感追緝令2
Bitter Harvest	烏克蘭悲歌
Fantastic Four	驚奇四超人
Good People	鎖命橫財
The Tale of Despereaux	雙鼠記
Mister lonely	當麥克先生遇見夢露小姐…
Miss Sloane	攻敵必救
Mississippi Grind	賭國大丈夫
Populaire	愛在彈指間
Stomp the Yard	獨步舞林
Spring	魔物戀人
The November Man	諜海無間
The Last Word	她其實沒那麼壞
St. Vincent	歐吉桑鄰好
League of Gods	封神傳奇
The Bad Batch	生存者
Hell Or High Water	赴湯蹈火
Moonlight	月光下的藍色男孩
Earth to Echo	地球迴聲
Survivor	倒數行動
The Congress	虛擬天后
Still Alice	我想念我自己
Empire State	帝國警戒
Sleeping With Other People	愛睡在一起
The Invasion	恐怖拜訪
2012	2012
House of Lies	謊言對決
Tangled	魔髮奇緣
Snow Cake	雪季過客
Neighbors 2	惡鄰纏身2
Encounters at the End of the World	冰旅記事
The Only Living Boy in New York	活著的男孩
The Hitchhiker's Guide to the Galaxy	星際大奇航
Kidnapping Mr. Heineken	綁架海尼根
The Frozen Ground	冰封之地
Perfume: The Story of a Murderer	香水
Weirdsville	怪胎鎮
Pacific Rim	環太平洋
Inside Out	腦筋急轉彎
A Nightmare on Elm Street	半夜鬼上床
Dylan Dog: Dead of Night	狄倫犬:惡夜偵探
P.S. I Love You	PS.我愛
R.I.P.D.	降魔戰警
Breaking News	大事件
Thelma	女神賽爾瑪
Blade Runner 2	銀翼殺手2
Incredibles 2	超人特攻隊2
Because of Winn-Dixie	多虧有你
Southland Tales	南國傳奇
Special Forces	沙漠神兵
London Has Fallen	全面攻佔2
The Pink Panther 2	粉紅豹2
The Captive	雪地迷蹤
Kingdom of Heaven	天者天下
Trust the Man	相信你的男人
Sherlock Holmes	福爾摩斯
Suicide Squad	自殺突擊隊
The Uninvited	不請自來
Silver Linings Playbook	派特的幸福劇本
About Last Night	昨夜風流
The Help	姊妹
The Hunger Games: Mockingjay - Part 1	飢餓遊戲3
The Last King of Scotland	蘇格蘭之王
Battle of the Sexes	勝負反手拍
Strangrland	陌生之地
Vampire Academy	吸血鬼學院
Tomb Raider	古墓奇兵
The Pursuit of Happyness	當幸福來敲門
Venus	維納斯
The Vicious Kind	惡劣的善意
Crank: High Voltage	快克殺手2
I Am Michael	麥可—我的直男前男友
King's Ransom	國王贖金
Eat, Pray, Love	一個人的旅行
Me Before You	我就要你好好的
The Holiday	戀愛沒有假期
The Circle	直播風暴
Alita: Battle Angel	艾莉塔:戰鬥天使
Oblivion	遺落戰境
Goosebumps	怪物遊戲
Muppets Most Wanted	布偶歷險記2
The 15:17 to Paris	15:17巴黎列車
The Lucky Ones	真情旅程
The Ant Bully	聯合縮小兵
When the Game Stands Tall	攻無不克
We Need to Talk About Kevin	凱文怎麼了？
The Mortal Instruments: City of Bones	骸骨之城
The Young Messiah	少年彌賽亞
Paradise Now	天堂此時
Diary of a Mad Black Woman	瘋婆娘日記
The Way Back	亡命千萬里
Ten Thousand Saints	輕狂時代
Mortdecai	神鬼大盜
The Libertine	風流才子
Let the Right One In	血色入侵
Aliens in the Attic	樓上鄰居外星人
O'Horten	霍頓的鐵道人生
Firewall	防火牆
Magic in the Moonlight	月光魔法
Train to Busan	屍速列車
Timecrimes	時間殺人
Pitch Perfect	歌喉讚
The Bourne Ultimatum	神鬼認證3
Ben-Hur	賓漢
Solomon Kane	所羅門傳奇
Sukiyaki Western Django	日式牛仔一品鍋
The Oxford Murders	牛津殺人魔
The Other Woman	愛與親愛的
Fantastic Four: Rise of The Silver Surfer	驚奇四超人2
Rough Night	女狼嗨到趴
Did You Hear About the Morgans?	名牌冤家
A Most Violent Year	暴力年代
Silence	沉默
Girls Trip	閨蜜假期
Prime	春心蕩漾
Charlotte's Web	夏綠蒂的網
Infamous	柯波帝:冷血污名
Flicka	真愛無韁
Geostorm	氣象戰
Flyboys	空戰英豪
Red Cliff	赤壁
Happy Endings	快樂結局
The Jane Austen Book Club	珍奧斯汀讀書會
The Edge of Heaven	天堂邊緣
The Devil Wears Prada	穿著Prada的惡魔
The A-Team	天龍特攻隊
Melinda and Melinda	雙面瑪琳達
Shrooms	死神魔菇
Neighborhood Watch	巡邏驚很大
London Boulevard	倫敦大道
The Island	絕地再生
Saw VII 3D	奪魂鋸3D
Thank You for Your Service	感謝您為國效力
Pirates of the Caribbean: At Worlds End	神鬼奇航3
Gnomeo & Juliet	糯米歐與茱麗葉
Paranormal Activity: The Marked Ones	鬼入鏡:詛咒
Turbo	渦輪方程式
The Lake House	跳越時空的情書
The Equalizer	私刑教育
A Good Woman	美麗誘惑
Project X	派對X檔案
City of Ember	微光城市
All The Money In The World	金錢世界
Valley of Love	愛重逢以後
Skyfall	007空降危機
Garfield's A Tale of Two Kitties	加菲貓2
My Golden Days	追憶燦爛年華
The Return	回魂
Sahara	撒哈拉
Hoodwinked Too! Hood vs. Evil	Kuso小紅帽2
King Arthur: Legend of the Sword	亞瑟:王者之劍
Inhumans	異人族
Paddington 2	柏靈頓2:熊熊出任務
Mortal Engines	移動城市:致命引擎
Final Girl	最後尖叫女王
Breach	雙面特工
The Intern	高年級實習生
Romulus, My Father	我的父親羅慕勒斯
Date Night	約會喔麥尬
D.E.B.S.	高校女特務
The Wait	西西里的漫長等待
Parental Guidance	祖父母囧很大
Solitary Man	孤單男人
9/11	911絕命電梯
Cats & Dogs: The Revenge of Kitty Galore	貓狗大戰2
Incarnate	卡內陰
Les Miserables	悲慘世界
District 9	第九禁區
The Good Doctor	狼心仁術
Coach Carter	卡特教頭
In Bruges	殺手沒有假期
Talk to Me	誰來叩應
The Good, the Bad and the Weird	神偷獵人斷指客
MindGamers	腦波遊戲
Red Tails	熾天之翼
African Cats	非洲大貓
Nobody Knows	無人知曉夏日清晨
And If We All Lived Together	六人行不行
10 Items or Less	真情不打烊
百萬殺人實驗	百萬殺人實驗
Adore	愛墮落
Forever Strong	奮戰不懈
The Founder	速食遊戲
James Cameron's Deepsea Challenge 3D	深海挑戰3D
The Chronicles of Narnia: The Lion, The Witch and The Wardrobe	納尼亞傳奇
In the Land of Women	左右逢緣
The Best Exotic Marigold Hotel	金盞花大酒店
In the House	登堂入室
Factory Girl	明星夢工廠
The Girl Who Kicked the Hornet's Nest	直搗蜂窩的女孩
Charlie Countryman	這該死的愛
The Life Before Her Eyes	失序人生
Despicable Me 3	神偷奶爸3
Hesher	頑劣份子
Sky High	超人高校
Son of God	上帝之子
John Wick 2	捍衛任務2
The Overnight	越夜越狂
A Dangerous Method	危險療程
Herbie: Fully Loaded	金龜車賀比
Taken 2	即刻救援2
The Avengers	復仇者聯盟
El Cantante	歌神
Stealth	機戰未來
Pirates of the Caribbean: On Stranger Tides	神鬼奇航4
Of Gods and Men	人神之間
Steamboy	氣男孩
Dom Hemingway	海明威好賊
The Divide	末日碉堡
Daddy's Home	家有兩個爸
Disconnect	疏離世界
300: Rise of an Empire	300壯士2
Beautiful Creatures	美麗魔物
Syriana	諜對諜
Oldboy	原罪犯美國版
The Conjuring 2	厲陰宅2
Invincible	所向披靡
Never Let Me Go	別讓我走
The Human Centipede	人形蜈蚣
Once	吟遊戀人
The Search for General Tso	尋找左宗棠
Inferno	地獄
Jobs	賈伯斯
Loving Vincent	梵谷:星夜之謎
Jumanji: Welcome to the Jungle	野蠻遊戲
Alvin and the Chipmunks: The Road Chip	鼠來寶4
Get Hard	刑前教育
Bravetown	樂動
Revolver	玩命左輪
Summer Wars	夏日大作戰
The Sisterhood of the Traveling Pants 2	牛仔褲的夏天2
Agora	風暴佳人
Mother's Day	母親劫
Green Street Hooligans	綠街大火拼
Three	3人擠不擠
It's Already Tomorrow in Hong Kong	愛情無時差
Ghosts of Girlfriends Past	舊愛找麻煩
Get on Up	激樂人心
Wolf Totem	狼圖騰
Roaring Currents	鳴梁:怒海交鋒
The Dark Knight Rises	黑暗騎士:黎明昇起
Perfect Stranger	勾引陌生人
The Kite Runner	追風箏的孩子
Entourage	我家也有大明星
Ocean's 8	瞞天過海:八面玲瓏
Alvin and the Chipmunks: The Squeakuel	鼠來寶2
Flawless	天衣無縫
The Great Gatsby	大亨小傳
Transporter 3	玩命快遞3
Departures	送行者
Taxi	計程人生
Dumb and Dumber To	阿呆與阿瓜2
Get Out	逃出絕命鎮
Pretty Persuasion	美麗壞姐妹
Love Is Strange	愛,不散
Zookeeper	全民情獸
Writers	寫意人生
Cheri	嫩男謝利
Dirty Deeds	下流高校
The Lion King 3D	獅子王3D
A Bigger Splash	池畔謎情
Their Finest	他們的美好時光
The Science of Sleep	潛意識夢遊
Anonymous	莎士比亞的秘密
Immortals	戰神世紀
Old Dogs	歐吉桑卡好
Vantage Point	刺殺據點
Pitch Perfect 3	歌喉讚3
The Girl with the Dragon Tattoo	龍紋身的女孩
Firehouse Dog	我家也有消防狗
5x2	5X2愛情賞味期
Precious Cargo	終極
Heights	愛在紐約破曉時
2 Days in New York	紐約二日情
Sherrybaby	雪莉寶貝
Freaks of Nature	怪獸高中
The Cave Of The Yellow Dog	小黃狗的窩
Life	異星智慧
Starred Up	超危險人物
Desierto	最後一次自由
Kung Fu Panda	功夫貓熊
The Water Horse: Legend of the Deep	尼斯湖水怪
Gold	金爆內幕
The Wailing	哭聲
Doctor Strange	奇異博士
Omar	奧瑪的抉擇
Enchanted	曼哈頓奇緣
Extraction	終極救援
The Accidental Husband	我的意外老公
Jumper	移動世界
Death at a Funeral	超完美告別
John Wick	捍衛任務
The Transporter Legacy	玩命快遞4
Looking for Comedy in the Muslim World	笑翻清真寺
Little Man	小孩好黑
Ida	依達的抉擇
Gunman	全面逃殺
Still Life	無人出席的告別式
Red Eye	赤眼玄機
Enough Said	愛在不言中
Independence Day 2: Resurgence	ID4星際終結者2
Somewhere	我的明星老爸
The Wedding Date	嫁期
Mr. and Mrs. Smith	史密斯任務
Redline	熾色炫風
The Lego Batman Movie	樂高蝙蝠俠電影
The Fault in Our Stars	生命中的美好缺憾
The Expendables 3	浴血任務3
99 Homes	居住正義
30 Minutes or Less	菜鳥搶銀行
Now You See Me: The Second Act	忍者龜2:出神入化2
Appaloosa	鐵腕豪情
The Sitter	驚夜誰保姆
King Kong	金剛
Skateland	滑輪風暴
127 Hours	求生127小時
Lady Chatterley	查泰萊夫人
The Beautiful Person	巴黎小情人
Kingsglaive: Final Fantasy XV	王者之劍:太空戰士15電影版
Down in the Valley	愛在山谷下
Blackhat	黑帽
Typhoon	颱風
The Strangers: Prey at Night	陌路狂殺2
Rosewater	叛諜風暴
Zootopia	動物方城市
A Prophet	大獄言家
Fair Game	不公平的戰爭
The Proposal	愛情限時簽
The Humbling	百老匯熟男日記
Wish Upon	奪命潘朵拉
Exists	神出鬼沒
Case 39	39號特案
The Nines	九度空間
Enemy	雙面危敵
Postal	喋血街頭
The Danish Girl	丹麥女孩
Fifty Shades Darker	格雷的五十道陰影2
Cinderella	仙履奇緣
Miss Congeniality 2: Armed and Fabulous	麻辣女王2
Mini's First Time	蜜妮初體驗
A Walk in the Woods	別跟山過不去
The Exorcism of Emily Rose	驅魔
For Your Consideration	問鼎奧斯卡
Atomic Blonde	極凍之城
Dare	敢愛敢當
Captain America: The Winter Soldier	美國隊長2
Main Street	榮耀大道
The Sorcerer's Apprentice	魔法師的學徒
Valerian and the City of a Thousand Planets	星際特工瓦雷諾:千星之城
The Twilight Saga: New Moon	暮光之城2
The Accountant	會計師
We Bought a Zoo	我們買下了動物園
Viva	變裝皇后萬萬歲
The Apparition	鬼次元
Crimson Peak	腥紅山莊
Blue is the Warmest Color	藍色是最溫暖的顏色
T2: Trainspotting	猜火車2
9	9
Life of Pi	少年Pi的奇幻漂流
Marina Abramovic: The Artist Is Present	凝視瑪莉娜
The Hills Have Eyes	山
The Broken Circle Breakdown	愛的餘燼
Jane Eyre	簡愛
No Regret	愛無悔
Misconduct	魔鬼總裁
Hotel Transylvania 3	尖叫旅社3
TOKYO !	東京狂想曲
Sorority Row	女生殺人宿舍
The Adventures of Shark Boy and Lava Girl in 3-D	立體小奇兵
I Origins	人之初
Where to Invade Next	插旗攻城市
House of Pleasures	巴黎妓院回憶錄
The Boss of It All	老闆我最大
Runner Runner	逆轉王牌
I Hate Valentine's Day	我恨情人節
The Flight of the Red Balloon	紅氣球
Only God Forgives	末路殺神
Brooklyn's Finest	惡夜特警隊
Black Sea	黑海
Seven Pounds	七生有幸
Safe Haven	愛情避風港
Wanderlust	隨心所欲
By the Sea	海邊
The Spiderwick Chronicles	奇幻精靈事件簿
Alien vs. Predator 2	異形戰場2
Asylum	愛慾癡狂
Black Sheep	黑綿羊
Notes on a Scandal	醜聞筆記
G-Force	鼠膽妙算
The 9th Life of Louis Drax	路易的第9條命
The Page Turner	琴謎變奏曲
Monster House	怪怪屋
I.O.U.S.A.	巴菲特報告
The Book Thief	偷書賊
Nothing Like the Holidays	聖誕佳節
Pathology	恐怖解剖室
Is Anybody There?	有人在家嗎?
Bad Johnson	強森好屌
The Shack	心靈小屋
Elegy	垂死的肉身
Turtles Can Fly	烏龜也會飛
Dogtooth	非普通教慾
Deadpool 2	死侍2
Hitchcock	希區考克
Outside The Law	光榮時刻
Grown Ups 2	亞當等大人2
Lovelace	A片女神
The Light Between Oceans	為妳說的謊
The Perks of Being a Wallflower	壁花男孩
Sex and Death 101	101夜情
My Soul to Take	死期倒數24小時
How I Live Now	我的生存之道
Bee Movie	蜂電影
Wild	那時候,我只剩下勇敢
The Grandmasters	一代宗師
The Lobster	單身動物園
Vehicle 19	玩命車手
Harry Potter and the Deathly Hallows - Part 1	哈利波特7.1
The Purge: Anarchy	國定殺戮日2
The Three Stooges	三個臭皮匠
The Final Season	最後的球季
Jindabyne	湖濱疑雲
Amour	愛•慕
Lincoln	林肯傳
Balls of Fury	乒乓特派員
(500) Days of Summer	分手的那一天
Final Destination 5	絕命終結站5
Punisher: War Zone	神鬼制裁2
Bedtime Stories	天方夜
Transformers: The Last Knight	變形金剛5
The Nut Job	堅果任務
The Legend of Zorro	蒙面俠蘇洛2
Beastly	夢魘情人
Max	軍犬麥斯
Molly's Game	決勝女王
Martian Child	我的火星小孩
Macbeth	馬克白
I Am Legend	我是傳奇
Patriots Day	愛國者行動
Redacted	波灣陰謀
Alien: Covenant	異形:聖約
Eden	巴黎電幻世代
The Upside of Anger	愛你愛到快抓狂
Zathura	迷走星球
Trumbo	好萊塢的黑名單
Ricky	讓愛飛起來
If I Want to Whistle, I Whistle	如果我想吹口哨
Meet the Fockers	門當父不對3
Poltergeist	鬼哭神嚎
The Great Debaters	雄辯天下
Red Dawn	紅潮入侵
Words and Pictures	字畫情緣
Saraband	薩拉邦德舞曲
Trolls	魔髮精靈
Atonement	贖罪
Victor Frankenstein	怪物
Death Note	死亡筆記本
Sex and the City: The Movie	慾望城市電影版
Hidden Figures	關鍵少數
Chaos Theory	混沌理論
Last Vegas	賭城最後一夜
In the Heart of the Sea	白鯨傳奇
Take the Lead	獨領風潮
I Am Love	我愛故我在
A Little Bit of Heaven	想愛趁現在
Like Crazy	瘋一樣的男子
Brad's Status	人生剩利組
Penelope	真愛之吻
The Nutcracker in 3D	魔境冒險3D
Dreamer: Inspired by a True Story	夢想奔馳
The Boy	託陰
A Tale of Love and Darkness	愛與黑暗的故事
The Chronicles of Narnia:	納尼亞傳奇3
The Last Days on Mars	星際禁區
Manchester by the Sea	海邊的曼徹斯特
Spring Breakers	放浪春假
The Wall	危牆狙擊
The Wedding Ringer	伴郎友沒友
Nine Lives	我的老爸喵星人
Under the Skin	肌膚之侵
The Beguiled	魅惑
Mirror Mirror	魔鏡魔鏡
The Road to Guantanamo	通往關達那摩之路
Journey to the West: Conquering the Demons	西遊：降魔篇
The Town	竊盜
November	驚狂十一月
My Old Lady	巴黎窈窕熟女
Madagascar: Escape 2 Africa	馬達加斯加2
Van Wilder 2: The Rise of Taj	凸種高材生2
The Human Centipede II	人形蜈蚣2
Easy Virtue	水性楊花
Before I go to sleep	別相信任何人
The Look of Silence	沉默一瞬
Batman: The Killing Joke	蝙蝠俠:致命玩笑
The Mysteries of Pittsburgh	匹茲堡的秘密
Secret in Their Eyes	沉默的雙眼
Slumdog Millionaire	貧民百萬富翁
XXY	我是女生,也是男生
Million Dollar Arm	金臂美國夢
Coherence	彗星來的那一夜
Constantine	驅魔神探
Tristan & Isolde	崔斯坦與依索德
Unknown	玩命記憶
Dynamite Warrior	功夫拳霸
The Farewell Party	快樂告別的方法
The Cobbler	命運鞋奏曲
The Lego Ninjago Movie	樂高炫風忍者電影
Hot Tub Time Machine 2	扭轉時光機2
In the Valley of Elah	震撼效應
Harry Potter and the Goblet of Fire	哈利波特4
My Summer of Love	我的夏日戀曲
Random Tropical Paradise	蜜月玩很大
Rings	七夜怪譚
Lost in Beijing	蘋果
The Amityville Horror	陰宅
Pan's Labyrinth	迷宮
The Internship	實習大叔
Rio	里約大冒險
Meet Bill	遇上比爾
Just My Luck	幸運之吻
Manglehorn	梅格漢的心靈鑰匙
The Boy and The Beast	怪物的孩子
Beauty and the Beast 3D	美女與野獸3D
Lakeview Terrace	合法入侵
Yes Man	沒問題先生
Universal Soldier: Day of Reckoning	魔鬼命令4
Mr. Peabody & Sherman	皮巴弟先生與薛曼的時光冒險
Hoodwinked	小紅帽
A Family Man	愛在回家時
November Criminals	追兇
The Secret Life of Pets	寵物當家
Charlie and the Chocolate Factory	巧克力冒險工廠
The Double	雙面諜
I Know Who Killed Me	雙面人質
Happily N'Ever After	從此沒有過著幸福快樂的日子
McFarland, USA	衝刺終點線
Passion	激情
I Don't Want to Sleep Alone	黑眼圈
Kicking & Screaming	踹球叫練
Gone Girl	控制
Despicable Me 2	神偷奶爸2
Truth	關鍵真相
Vitus	想飛的鋼琴少年
Duplicity	口是心非
12 Rounds	血戰12輪
The Secret of Kells	凱爾斯的秘密
Rock of Ages	搖滾時代
The Kingdom	反恐戰場
3 Idiots	三個傻瓜
Disaster Movie	終極災難電影
Dark Water	鬼水
The Santa Clause 3	聖誕快樂又瘋狂3
Pompeii	龐貝:最後之日
Star Trek 3	星際爭霸戰3
War for the Planet of the Apes	猩球崛起3
Big Stan	猛男姦獄
Underworld: Rise of the Lycans	決戰異世界3
The Raid	反恐精英
Klown	丑男大丈夫
Pride and Glory	光榮戰警
Role Models	模範大哥哥
Sing	歡樂好聲音
War, Inc.	戰爭製造公司
The Dukes of Hazzard	飆風天王
Big Hero 6	大英雄天團
Hitman: Agent 47	刺客任務
The Judge	大法官
Star Wars: Episode III - Revenge of the Sith	星際大戰第三部曲
Bomb the System	轟炸街頭
Rize	熱街勁舞
Cherry Blossoms	當櫻花盛開
The Other Woman	婦仇者聯盟
Knight of Cups	聖杯騎士
Ice Age: Dawn of the Dinosaurs	冰原歷險記3
Flatliners	別闖陰陽界
Planet B-Boy	街舞開戰
Ride Along	一路靠北
The Refuge	逐愛角落
The Debt	惡棍狙擊
Lars and the Real Girl	充氣娃娃之戀
Away From Her	妳的樣子
You Again	冤家囍相逢
Embrace of the Serpent	夢遊亞馬遜
Unleashed	寵物情人
The Adjustment Bureau	命運規劃局
Beaufort	前陷風暴
Stardust	星塵情緣
Ant-Man	蟻人
Baby Driver	玩命再劫
Kontroll	地鐵迷宮
The Foreigner	英倫對決
Before I Wake	撕眠
Oldboy	老男孩
Three...Extremes	三更2
Hotel Transylvania 2	尖叫旅社2
The Boss	甜心大姐頭
The Skeleton Twins	人生雙告急
Wolf Creek 2	鬼哭狼嚎2
Whip It	飆速青春
Sicario	怒火邊界
Journey 2: The Mysterious Island	地心冒險2
Keep The Lights On	為你流的淚
Bridge to Terabithia	尋找夢奇地
Taichi 0	太極
Kidnap	綁架
Godzilla Resurgence	正宗哥吉拉
The Hunger Games: Mockingjay - Part 2	飢餓遊戲3.2
The Jungle Book	與森林共舞
Love Songs	巴黎小情歌
Valkyrie	代號:華爾奇麗亞
An Inconvenient Truth	不願面對的真相
Victoria and Abdul	女王與知己
Devil's Due	惡靈嬰弒
Think Like a Man Too	男人行不行2
The Best of Me	有你,生命最完整
Renoir	印象雷諾瓦
Nanking	被遺忘的1937
Home Again	愛情齡距離
The Act of Killing	殺人一舉
The Adventures of Tintin: Secret of the Unicorn	丁丁歷險記
Marebito	稀人
Nim's Island	尼魔島
Paul Blart: Mall Cop 2	百貨戰警2
American Gangster	美國幫派
Mail Order Wife	伊媚兒新娘
Testament of Youth	青春誓言
A Royal Affair	皇家風流史
The Stepfather	繼父疼死你
Certified Copy	愛情對白
The Spectacular Now	戀夏進行式
The Fantastic Mr. Fox	超級狐狸先生
The Last Mistress	情慾二重奏
Gambit	金牌手
The Possession	聚魔櫃
Insidious	陰兒房
Closed Circuit	全面鎖定
The Hangover Part II	醉後大丈夫2
A Dog's Purpose	為了與你相遇
Serena	瞞天殺機
Tetro	泰特羅
Golden Compass	黃金羅盤
In Her Shoes	偷穿高跟鞋
Martha Marcy May Marlene	迷懵夢寐
Pride and Prejudice	傲慢與偏見
Four Brothers	四虎出閘
House of D	傷心往事
The Maze Runner	移動迷宮
The Wind That Shakes the Barley	吹動大麥的風
Jack Ryan	傑克萊恩
Her	雲端情人
Exiled	放逐
The Immigrant	浮世傷痕
Blind Dating	盲目約會
A Hologram for the King	梭哈人生
Lilting	輕輕搖晃
The World	世界
Locke	失速人生
Me and You and Everyone We Know	愛情你我她
Footloose	渾身是勁2011
Monster Hunt	捉妖記
The Assassin	刺客聶隱娘
The Young Victoria	維多利亞女皇情史
Be Cool	黑道比酷
Beowulf & Grendel	勇士傳奇
Snow Angels	雪天使
Old Joy	舊夢
Innocent Voices	純真的聲音
The Martian	絕地救援
Final Girl	前嫌盡弒
The Lincoln Lawyer	下流正義
The People I've Slept With	姣妹日記
Safe House	狡兔計畫
Titanic 3D	鐵達尼號3D版
Planes: Fire & Rescue	飛機總動員2
G.I. Joe 2: Retaliation	特種部隊2
Magic Magic	荒島魔咒
Kung Fu Panda 3	功夫熊貓3
Sully	薩利機長
Upside Down	顛倒世界
The Second Best Exotic Marigold Hotel	金盞花大酒店2
Into the Woods	魔法黑森林
Ajami	遠離阿雅米
Winnie the Pooh	小熊維尼電影版
Stephanie Daley	未婚媽媽
The Secret of the Grain	家傳秘方
One Missed Call	鬼來電西洋篇
Guardians of the Galaxy	星際異攻隊
Everybody's Fine	天倫之旅
Equals	禁愛世界
Marmaduke	酷狗馬馬杜
The Counterfeiters	偽幣製造者
The September Issue	時尚惡魔的聖經
The Brothers Grimsby	特務大臨演
A Thousand Times Good Night	一千次晚安
Saw 2	奪魂鋸2
Therapy for a Vampire	吸血鬼腥靈診療
Rocky Balboa	洛基6
The Mutant Chronicles	突變末日
The Big Sick	愛情昏迷中
The Concert	交響人生
Flightplan	空中危機
The Horsemen	天啟四騎士
Cars 2	汽車總動員2
Southpaw	震撼擂台
Rango	飆風雷哥
Nerve	玩命直播
This is Where I Leave You	愛在頭七天
Look at Me	看看我聽聽我
Live Free or Die Hard	終極警探4
Miami Vice	邁阿密風雲
Nights in Rodanthe	羅丹薩的夜晚
I'm Still Here	我仍在這裡
Neerja	妮嘉
Night at the Museum	博物館驚魂夜
Junebug	妙媳婦見公婆
Ride Along 2	一路靠北2
Hide and Seek	捉迷藏
The Lovely Bones	蘇西的世界
True Grit	真實的勇氣
The Bling Ring	星光大盜
Bushwick	全境警戒
Wonderstruck	奇光下的秘密
Emperor	天皇
4 Months, 3 Weeks and 2 Days	4月3週又2天
Oz: The Great and Powerful	奧茲大帝
Kiss Kiss, Bang Bang	吻兩下打兩槍
Hercules: The Legend Begins	鋼鐵力士
Sleepless	限時救援
Exodus: Gods and Kings	出埃及記
Elektra	幻影殺手
The Lost City	遺忘故都
Viceroy's House	亂世傷痕:末代總督的秘密
Next	下一秒
Youth	年輕氣盛
Poetry	生命之詩
He's Just Not That Into You	他其實沒那麼喜歡妳
The Babadook	鬼敲門
Orphan	孤兒怨
The Mermaid	美人魚
March of the Penguins	企鵝寶貝
Day Watch	決戰日
Colossal	柯羅索巨獸
The Boy Next Door	隔壁的男孩殺過來
Rocket Science	一飛沖天
Good Time	失速夜狂奔
Swiss Army Man	屍控奇幻旅程
Wedding Crashers	婚禮終結者
Cloudy with a Chance of Meatballs	食破天驚
To Rome with Love	愛在羅馬
The Forbidden Kingdom	功夫之王
The Sessions	性福療程
Supercross	越野狂飆
Burlesque	舞孃俱樂部
Astro Boy	原子小金剛
Straw Dogs	惡鄰古堡
The Russian Dolls	西班牙公寓2
Oculus	鬼遮眼
Need For Speed	極速快感
The Soloist	心靈獨奏
Transsiberian	亡命西伯利亞
Howl's Moving Castle	霍爾的移動城堡
Wind Chill	斷魂谷
Guardians of the Galaxy Vol. 2	星際異攻隊2
47 Meters Down	深海鯊機
Admission	非關入學
You Won’t Get to Live Twice	三個大丈夫
Big Momma's House 2	絕地奶霸2
Miss March	三月封面女郎
The Legend of Tarzan	泰山傳奇
Live by Night	夜行人生
The Faith of Anna Waters	安娜華特
Fifty Shades Freed	格雷的五十道陰影3
Dear  Frankie	來信情緣
labor day	一日一生
Begin Again	曾經,樂是唯一
Winter's Bone	凍死骨
Justin Bieber: Never Say Never	小賈斯汀:挑戰不可能
The Human Centipede 3	人形蜈蚣3
Bad News Bears	小熊出擊
Fast & Furious 6	玩命關頭6
Ouija 2	碟仙2
Predators	終極戰士3
If I Stay	如果我留下
Step Up All In	舞力全開5
House	魔咒鬼屋
I Give It a Year	一年之癢
No Reservations	料理絕配
American Assassin	美國刺客
Some Freaks	怪怪惹人愛
Life after Beth	殭屍哪有這麼正
Deadpool	死侍
Enter the Void	嗑到荼蘼
Romeo and Juliet	羅密歐與茱麗葉
Flash of Genius	智慧戰爭
Plush	絨毛團
No Escape	無處可逃
Laggies	大愛晚成
Margaret	瑪格麗特
Are We Done Yet?	有完沒完
The Hobbit: The Battle of the Five Armies	哈比人3
Winter Solstice	冬至
Twin Sisters	烽火孿生淚
Soul Surfer	靈魂衝浪
Operation Mekong	湄公河行動
Beloved Sisters	狂愛姊妹花
The Smurfs 2	藍色小精靈2
It	牠
The Year of the Yao	姚明來了
Harold and Kumar Escape From Guantanamo	豬頭漢堡飽2
The Dilemma	進退兩難
Aftershock	巨震過後
The Raven	愛倫坡懸案
Resident Evil: Retribution	惡靈古堡5
Captain Fantastic	神奇大隊長
Men in Black III	MIB星際戰警3
Frozen River	急凍邊境
Love the Coopers	聖誕好家在
Bewitched	神仙家庭
Café Society	咖啡愛情
The Princess and the Frog	公主與青蛙
Pirates of the Caribbean: Dead Men Tell No Tales	神鬼奇航5
Jarhead	鍋蓋頭
Bottle Shock	戀戀酒鄉
Control	不再克制
Vanishing on 7th Street	消失在第七大街
Terminator: Genesis	魔鬼終結者5
Mountains May Depart	山河故人
How to Train Your Dragon 2	馴龍高手2
One for the Money	頭號冤家
Mud	阿泥正傳
Before We Go	紐約愛未眠
Harry Potter and the Deathly Hallows - Part 2	哈利波特7.2
The Goods: Live Hard. Sell Hard.	王牌推銷員
Youth Without Youth	時光逆侶
Mr. Turner	透納先生
30 Days of Night	夜三十
Separate Lies	婚約裂痕
Avengers: Infinity War	復仇者聯盟3
The Reluctant Fundamentalist	拉合爾茶館的陌生人
Doogal	毛毛狗
Bad Grandpa	無厘取鬧:阿公壞壞
I've Loved You So Long	我一直深愛著你
Keanu	基努賤隊
Argo	亞果出任務
Buried	活埋
Antichrist	撒旦的情與慾
Paul	我們撞到外星人
Captain Phillips	怒海劫
Paul Blart: Mall Cop	百貨戰警
Stories We Tell	莎拉波莉家庭詩篇
Dr. Seuss' Horton Hears a Who	荷頓奇遇記
Legend of the Guardians	貓頭鷹守護神
The BFG	吹夢巨人
The Commuter	疾速救援
Peter and Vandy	彼得與溫蒂之戀
Last Chance Harvey	愛,從心開始
Formosa Betrayed	被出賣的台灣
Jackie	第一夫人的秘密
Undertow	暗擁
Left Behind	末日迷蹤
I Am Not Madame Bovary	我不是潘金蓮
The Ides of March	選戰風雲
Birdman	鳥人
xXx: The Return of Xander Cage	限制級戰警3
The Strangers	陌路狂殺
The Past	咎愛
The Last Exorcism	最後大法師
Toni Erdmann	顛父人生
Bel Ami	美男子
Batman Begins	蝙蝠俠:開戰時刻
One Direction: This Is Us	1世代
Letters to Juliet	給茱麗葉的信
The Ring Two	剎靈
Gone Baby Gone	失蹤人口
Annabelle 2	安娜貝爾2
Citizenfour	第四公民
A Taxi Driver	我只是個計程車司機
Seediq Bale	賽德克巴萊
The Golden Era	黃金時代
Mamma Mia! Here We Go Again	媽媽咪呀2
V For Vendetta	V怪客
Alien Abduction	詭影訪客
Railroad Tigers	鐵道飛虎
[REC] 4: Apocalipsis	錄到鬼4
A Perfect Getaway	蜜月變奏曲
Mechanic: Resurrection	極速秒殺2
The Dark Tower	黑塔
Slither	撕裂人
Horrible Bosses 2	老闆不是人2
Fracture	破綻
Captain America: The First Avenger	美國隊長
Before I Fall	還有機會說再見
The Switch	精選完美男
Fool's Gold	傻愛成金
The Boys Are Back	親愛的小孩
Invictus	打不倒的勇者
Ice Age: Continental Drift	冰原歷險記4
Obsessed	鬼迷心竅
Underworld 4	決戰異世界4
Fast & Furious 7	玩命關頭7
Conversations with Other Women	與陌生女子調情
Ruby Sparks	客製化女神
The Little Death	愛愛小確性
Tim Burton's Corpse Bride	地獄新娘
High Strung	舞力重擊
Cirque Du Freak: The Vampire's Assistant	鬼不理的助手
Kubo and the Two Strings	酷寶:魔弦傳說
In the Shadow of the Moon	月球暗面
Bus 657	關鍵救援:巴士657
The Other Man	外慾殺機
Case 39	39特案
Superman Returns	超人再
Heartless	魔鬼契約
Sinister 2	凶兆2:雙瘋
The Flying Swords of Dragon Gate	3D龍門飛甲
Grace of Monaco	摩納哥王妃
The Raid 2: Berandal	全面突襲2
Anchorman 2: The Legend Continues	銀幕大角頭2
Deck the Halls	裝璜東西軍
Katyn	愛在波蘭戰火時
The Best of Youth	燦爛時光
Welcome To Yesterday	跨界失控
A Good Day to Die Hard	終極警探5
Moon	月球漫遊
Before the Fall	英雄教育
Silent Hill	沉默之丘
Capitalism: A Love Story	資本主義
The Gift	非禮勿弒
Nanny McPhee	魔法褓母麥克菲
Free Birds	自由鳥
The Dying Gaul	垂死的高盧人
The Hitcher	幽靈終結者
The Little Hours	色慾修道院
Miss Potter	波特小姐
Hugo	雨果的冒險
Killshot	生死一擊
Time to Leave	愛無止期
Deepwater Horizon	地平線
Song to Song	為妳唱的歌
Blades of Glory	冰刀雙人組
The Homesman	逃離邊境
Three Times	最好的時光
The Vatican Tapes	梵諦岡影帶
Step Up 2 the Streets	舞法舞天2
Fright Night	吸血鬼就在隔壁3D
Big Miracle	鯨奇之旅
This Is It	未來的未來
Kumiko, the Treasure Hunter	久美子的奇異旅程
The Penguins of Madagascar	馬達加斯加爆走企鵝
Brooklyn	愛在他鄉
My One and Only	世界唯一的你
12 Strong	12猛漢
The Private Lives of Pippa Lee	她的私密日記
A Mighty Heart	無畏之心
Love	性本愛
The Other Side of the Door	鬼門開
The Awakening	靈動檔案
W.	請問布希大人
Saw VI	奪魂鋸6
Fifty Shades of Grey	格雷的五十道陰影
Jonas Brothers:The 3D Concert Experience	強納斯兄弟演唱會
Rust & Bone	鏽與骨
Love and Honor	愛情逃兵
Sword Art Online the Movie: Ordinal Scale	刀劍神域劇場版－序列爭戰
Before the Devil Knows You're Dead	魔鬼知道你死前
The Descent	深入絕地
The Autopsy of Jane Doe	驗屍官
Were the World Mine	世界屬於我們
The Bad Lieutenant: Port of Call New Orleans	爆裂警官
The Hunger Games	飢餓遊戲
The Housemaid	下女
Friends with Kids	非婚生子
Dragonball	七龍珠
Machine Gun Preacher	機關槍傳教士
Casanova	濃情威尼斯
Shelter	避風港
Jack Reacher	神隱任務
Trade	走私人口
Two Days, One Night	兩天一夜
Whiplash	進擊的鼓手
Traitor	叛國者
The Great Wall	長城
Furious 8	玩命關頭8
Monster Trucks	怪獸卡車
No Good Deed	惡煞臨門
Confessions of a Shopaholic	購物狂的異想世界
A Single Man	摯愛無盡
Perfect Sense	末日情緣
Revolutionary Road	真愛旅程
Poseidon	海神號
All The King's Men	國王人馬
High-Rise	摩天樓
Justice League	正義聯盟
3-Iron	空屋情人
Final Destination: Death Trip 3D	絕命終結站4
Divergent	分歧者
Fast and Furious	玩命關頭4
Saw III	奪魂鋸3
Snitch	限時翻供
The Promise	無極
Edge of Darkness	驚爆萬惡城
Vicky Cristina Barcelona	情遇巴塞隆納
Heartbreaker	戀愛救火隊
Murderball	謀殺球
The Wolfman	狼嚎再起
Burning Blue	烈火擎天
The Informers	性謀殺天使城
Gomorra	罪惡之城娥摩拉
Time Renegades	時光叛逃者
The Book of Eli	永生書
Boyhood	年少時代
Wall Street: Money Never Sleeps	華爾街2
SiREN	妖物
Third Person	情慾三重奏
Golden Door	金色大門
A Bad Moms Christmas	阿姐響叮噹
The Walk	走鋼索的人
Stealing Cars	竊車犯
Seventh Son	第七傳人
The Imaginarium of Doctor Parnassus	帕納大師的魔幻冒險
The Nativity Story	降世錄
Ted 2	熊麻吉2
The Edukators	替天行盜
The Ballad of Jack and Rose	傑克與羅絲的民謠
World Trade Center	世貿中心
Made of Honor	新郎不是我
The Children of Huang Shi	黃石任務
Memoirs of a Geisha	藝妓回憶錄
Song One	真愛戀習曲
Mustang	少女離家記
The Green Inferno	食人煉獄
Black Panther	黑豹
Alone in the Dark	異形鬼屋
5 Days Of War	五日戰爭
Gus Van Sant's Last Days	成名終點站
24 Hours to Live	24小時殺到爆
Race to Witch Mountain	超異能冒險
The Vault	惡靈金庫
The Belko Experiment	辦公室大狂殺
Won't Back Down	永不放棄
Contagion	全境擴散
Regression	邪靈刑事錄
Cooties	殭屍小屁孩
Burnt	天菜大廚
Step Up 4	舞力全開4
Marie Antoinette	凡爾賽拜金女
Sex Tape	愛愛上雲端
Saving Face	面子
X-Men Origins: Wolverine	X戰警:金鋼狼
Madison	麥迪遜錦標賽
Spy	麻辣賤諜
Looper	迴路殺手
Mr. Popper's Penguins	波普先生的企鵝
The Intouchables	逆轉人生
The Numbers Station	數字戰
Maleficent	黑魔女:沉睡魔咒
What We Do In The Shadows	吸血鬼家庭詩篇
The Sorcerer and the White Snake	法海:白蛇傳說
Ong bak 2	拳霸3
Ong-Bak 3	拳霸終極篇
The Disappearance of Alice Creed	愛麗絲人間蒸發
Indigènes	光榮歲月
Death Defying Acts	魔幻奇緣
Annihilation	滅絕
Fateless	非關命運
Big Mommas: Like Father, Like Son	絕地奶霸3
A Haunted House	鬼屋入鏡
Drag Me to Hell	地獄魔咒
White Bird in a Blizzard	暴風雪中的白鳥
Far from the Madding Crowd	遠離塵囂
The Spirit	閃靈俠
Sleuth	非常衝突
Paranormal Activity: The Ghost Dimension	鬼入鏡5
Kingsman: The Golden Circle	金牌特務2
Wreck-It Ralph	無敵破壞王
The Beat That My Heart Skipped	我心遺忘的節奏
War Room	同室操戈
Pete's Dragon	尋龍傳說
Thirst	蝙蝠
Rise: Blood Hunter	血獵人
The Dry Land	荒涼大地
The Abandoned	廢墟
Melancholia	驚悚末日
Frances Ha	紐約哈哈哈
You Kill Me	殺死我吧
Son of the Mask	小鬼也摩登
Rudo y Cursi	圓夢旅程
Alexandra	亞歷珊卓
Hitch	全民情聖
Liberal Arts	愛情必修學
Grown Ups	亞當
The Boondock Saints II: All Saints Day	神鬼尖兵2
The Lady	翁山蘇姬
Freedom Writers	街頭日記
The Woman	女獸人
Skinwalkers	異族終結戰
The Boss Baby	寶貝老闆
The Maid	女僕
Walk of Shame	姐姐我醉大
The Devil Inside	心魔
A Christmas Tale	屬於我們的聖誕節
Green Room	納粹龐克
Youth in Revolt	青春轉大人
How to Be Single	單身啪啪啪
Conviction	非常上訴
XXX: State of the Union	限制級戰警2
Ghost House	鬼屋泰淒厲
Something New	心花漾
Arthur Christmas	聖誕快遞
Keeping Up with the Joneses	間諜大鄰演
Puss in Boots	鞋貓劍客
BloodRayne	吸血萊恩
Bolt	雷霆戰狗
Ladies in Lavender	薰衣草夫人
MacGruber	百戰天蟲
Paprika	盜夢偵探
Safe	火線反擊
The Tourist	色遇
Criminal	換腦行動
A Most Wanted Man	諜報風雲
Deep Blue	海底世界
The Black Balloon	吾愛無悔
Batman v Superman: Dawn of Justice	蝙蝠俠對超人
Colonia	窒命地
Percy Jackson & The Olympians: The Lightning Thief	波西傑克森:神火之賊
Flash Point	導火線
Transformers: Revenge of the Fallen	變形金剛2
Burying the Ex	我的屍控女友
2 Days in Paris	巴黎二日情
Crouching Tiger, Hidden Dragon: The Green Legend	臥虎藏龍2
Racing Stripes	斑馬快跑
Mommy	親愛媽咪
Twilight	暮光之城
Domino	女模煞
The King's Speech	王者之聲
Piranha 3-D	3D食人魚
Tinker, Tailor, Soldier, Spy	諜影行動
The Shaggy Dog	長毛狗
Furry Vengeance	野蠻大對決
The Man with the Iron Fists	功夫鐵拳
Thank You for Smoking	菸草之王
Unleashed	鬪犬
Silent Hill: Revelation 3D	沉默之丘2
Swimming Upstream	泳往直前
Florence Foster Jenkins	走音天后
Ingrid Goes West	網美嬉遊記
Arthur and the Invisibles	亞瑟
Nasty Baby	寶貝超級壞
The Counselor	玩命法則
Men, Women & Children	雲端男女
The Giver	記憶傳承人
Silk	異旅情絲
The 33	33:重生奇蹟
Beautiful Boxer	美麗拳王
The Dead Girl	謎樣女孩死亡事件
Life of Crime	百萬嬌妻綁架計畫
Darkest Hour	最黑暗的時刻
Sweeney Todd: The Demon Barber of Fleet Street	瘋狂理髮師
Tulpan	圖班嫁給我
Ip Man	葉問
Ferdinand	萌牛費迪南
The Disappearance of Eleanor Rigby	謎走愛情
Shutter Island	隔離島
Fifty Shades of Black	雷的五十道黑影
Evil Dead	屍變
When in Rome	羅馬不思議
Premium Rush	超急快遞
Hot Pursuit	辣味雙拼
Bite	X戰警:變蟲人
Hancock	全民超人
Rachel Getting Married	瑞秋要出嫁
Starship Troopers: Traitor of Mars	星艦戰將:火星叛徒
The Lookout	監守自盜
My Big Fat Greek Wedding 2	我媽的希臘婚禮
Let the Bullets Fly	讓子彈飛
Man of Steel	鋼鐵英雄
White Noise	鬼訊號
Scary Movie 5	驚聲尖笑5
Star Wars: Episode VII	星際大戰7
Hunger	飢餓
My Sister's Keeper	姊姊的守護者
Wind River	極地追擊
Material Girls	拜金女孩
Waiting	哈啦上菜
Chaos	虐殺
Jersey Boys	紐澤西男孩
The Back-up Plan	備胎女王
Finding Nemo 3D	海底總動員3D
College Road Trip	大學生了沒
Hostage	火線對峙
The Hangover Part III	醉後大丈夫3
Avenue Montaigne	巴黎蒙田大道
Rent	吉屋出租
Man of the House	啦妹當家
Waltz with Bashir	與巴席爾跳華爾滋
La La Land	樂來越愛你
Year of the Dog	好運汪汪來
Brothers	變奏曲
Paranormal Activity	靈動:鬼影實錄
Kill Your Darlings	殺死達令
Rise of the Apes	猩球崛起
Amy	艾美懷絲
The Only Living Boy in New York	紐約唯一
Imagine That	天才神算
Bridget Jone's Baby	BJ有喜
Surveillance	監視
Starter for 10	戀愛學分
Europa Report	歐羅巴報告
Cut Sleeve Boys	我愛斷背衫
The Good Guy	曼哈頓
Sympathy for Lady Vengeance	選擇
Cyrus	拖油瓶
City of Men	無法無天2
Ghost Rider: Spirit of Vengeance	惡靈戰警2
My Bloody Valentine 3-D	3D血腥情人節
Kit Kittredge: An American Girl	奇特女孩
The Borrowers	借物少女艾莉緹
The End of the Tour	寂寞公路
Searching For Sugar Man	尋找甜秘客
Frank	法蘭克
Dirty	汙點
A Haunted House 2	鬼屋電影2
The Simpsons Movie	辛普森家庭電影版
Sky Blue	晴空戰士
Ready Player One	一級玩家
Snatched	搶救千金
Cursed	魔咒
Blood Diamond	血鑽石
Hardcore Henry	超狂亨利
White Elephant	白象:無法之城
A Little Chaos	美人情園
The Matador	肝膽相照
The Imitation Game	模仿遊戲
All is Lost	遺落汪洋
Hop	開運兔
Downfall	帝國毀滅
The Bourne Legacy	神鬼認證4
Take Shelter	居安思危
Margin Call	黑心交易員的告白
Lassie	靈犬萊西
The Lazarus Effect	永夜魔女
Bad Teacher	霸凌女教師
The Snowman	雪人
Legend of the Fist: The Return of Chen Zhen	陳真:精武風雲
Yves Saint Laurent	時尚大師聖羅蘭
Imagine Me & You	新娘向後跑
Transformers: Dark of the Moon	變形金剛3
Mindhunters	8面埋伏
Transamerica	窈窕老爸
Cuban Fury	騷莎大塊呆
Straight Outta Compton	衝出康普頓
Australia	澳大利亞
Silent House	一噤到底美國版
Norbit	糯米正傳
The Skin I Live In	切膚慾謀
Wild Side	狂野三人行
The Darjeeling Limited	大吉嶺特快車
X-Men 3	X戰警3
Dredd	超時空戰警3D
Grbavica	旅行之歌
The Last Winter	歿日冰封
Sinister	凶兆
Shorts	神通魔法石
Uncertainty	玩命一擲
Spread	情聖終結者
The Interpreter	雙面翻譯
Paris 36	放牛班快樂頌
Johnny English Reborn	凸搥特派員2
Mother of Tears	木乃伊博物館
The Valet	巴黎換換愛
You Will Meet a Tall Dark Stranger	命中注定遇見愛
The Loft	偷情閣樓
Assassin's Creed	刺客教條
Goodbye Christopher Robin	再見羅賓
Insidious 4: The Last Key	陰兒房第4章
The Night Before	聖誕狂歡夜
A Thousand Words	千言萬語
Over the Hedge	森林保衛戰
Split	分裂
Prometheus	普羅米修斯
Hannibal Rising	人魔
Savage Grace	浮華陷阱
The Class	我和我的小鬼們
The Hobbit: The Desolation of Smaug	哈比人2
Baby Mama	寶貝媽媽
Water for Elephants	大象的眼淚
Spider-Man: Into the Spider-Verse	蜘蛛人:新宇宙
August: Osage County	八月
Blood Ties	烈血風雲
Parkland	關鍵目擊
10 Cloverfield Lane	科洛弗10號地窖
Somersault	我行我愛
To the Wonder	愛•穹蒼
The Girl Who Played with Fire	玩火的女孩
The Squid and the Whale	烏賊與鯨
The Fast and the Furious: Tokyo Drift	玩命關頭3
Haywire	即刻反擊
Tragedy Girls	姐姐妹妹殺起來
Kong: Skull Island	金剛:骷髏島
Underdog	超狗任務
Bait 3D	誘鯊
Bahubali 2: The Conclusion	巴霍巴利王2
The Wave	驚天巨浪
American Hustle	瞞天大佈局
How to Train Your Dragon	馴龍高手
This is the End	大明星世界末日
The Warrior's Way	黃沙武士
Red State	神愛弒人
Cronicas	深入虎穴
Robot & Frank	機器人與法蘭克
Hanna	殺手漢娜
X-Men: The New Mutants	變種人
Stronger	你是我的勇氣
The Boy in the Striped Pajamas	穿條紋衣的男孩
Bridge of Spies	間諜橋
Paterson	派特森
I, Frankenstein	科學怪人
The Expendables	浴血任務
Only Lovers Left Alive	噬血戀人
Dracula Untold	德古拉:永咒傳奇
The Invention of Lying	謊言先師
The Chronicles of Narnia: Prince Caspian	納尼亞傳奇2
In the Mix	愛情混音師
Glastonbury	搖滾世代
The Hoax	大亨偽傳
Mr. Right	真愛有夠殺
13	13搏命遊戲
Clean	錯的多美麗
The Black Dahlia	黑色大理花懸案
Goal! 2: Living the Dream...	疾風禁區2
Man of the Year	風雲人物
28 Weeks Later	28週毀滅倒數
The Last Airbender	降世神通
