Miss Julie	茱莉小姐
Bread of Happiness	幸福的麵包
Peter Rabbit	彼得兔
Eden	巴黎電幻世代
Berlin Syndrome	顫慄柏林
52Hz, I love you	52赫茲,我愛你
They Call Me Jeeg	叫我鋼鐵俠
Black & White Episode 1: The Dawn of Assault	痞子英雄首部曲
Muoi : The Legend of a Portrait	替屍鬼
The Players	偷情大丈夫
Paper Castles	愛同窗愛同床
Saw VII 3D	奪魂鋸
The Boss Baby	寶貝老闆
Ava	那年夏天的微光
Irrational Man	愛情失控點
Rainbow Song	電影情人夢
First Girl I Loved	初戀上女孩
Monster Trucks	怪獸卡車
Magnifica Presenza	亮演人生
Dead Awake	夢魔纏身
Shock Wave	拆彈專家
The Adventures of Tintin: Secret of the Unicorn	丁丁歷險記
The Deaths of Ian Stone	獵殺死神
The Spiritual World	屍魂落魄
Crows - Episode 0	漂丿男子漢
Brick Mansions	玩命特區
Crazy Racer	瘋狂的賽車
Leviathan	纏繞之蛇
Neighborhood Watch	巡邏驚很大
The Circle	直播風暴
Tea Fight	鬪茶
Our Time Will Come	明月幾時有
The Past	咎愛
The moment you fall in love	喜歡上你的那瞬間
Saw: Legacy	奪魂鋸8
Pieta	聖殤
Avenue Montaigne	巴黎不打烊
Amityville: The Awakening	陰宅2
Detective Conan: The Eleventh Stricker	名偵探柯南16
R2B：Return to Base	R2B:獵鷹行動
Souvenir	伴手禮
A Beautiful Star	美麗之星
Melody's Smile	微笑標本
Incendies	烈火焚身
Hannibal Rising	人魔
A Single Man	摯愛無盡
What Happened To Monday	獵殺星期一
I, Tonya	老娘叫譚雅
Horns	魔角
Ghost coins	死人錢
My One and Only	只愛多金男
The Last Days on Mars	星際禁區
The Chronicles of Narnia:	納尼亞傳奇3
52 Tuesdays	52個星期二
War Dance	烏干達天空下
Oculus	鬼遮眼
R.I.P.D.	降魔戰警
Pick the Youth	皮克青春
The Golden Era	黃金時代
殭屍哪有那麼帥?	殭屍哪有這麼帥?
Chasing The Drangon	追龍
Strangrland	陌生之地
My Words, My Lies - My Love	愛情謊言
Saw IV	奪魂鋸4
The Homesman	逃離邊境
映画ドラえもん　のび太の新魔界大冒険∼７人の魔法使い∼	大雄的新魔界大冒險
Winter Sleep	冬日甦醒
Bunny Drop	白兔玩偶
Snow White	名模神采
カイジ ∼人生逆転ゲーム∼	賭博默示錄
Kedi	愛貓之城
The Secert of Loch Ness	尼斯湖水怪傳說
K-20 怪人二十面相・伝	K-20:怪人二十面相
Gabriel’s Voice	來自天堂的音符
Day And Night	日夜激情
For More Sun II	夢想續航
Bridge to Terabithia	尋找夢奇地
Men in Black III	MIB星際戰警3
Ricky	讓愛飛起來
In the House	登堂入室
Masquerade	雙面君王
Life after Beth	殭屍哪有這麼正
Deadpool 2	死侍2
Mortal Engines	移動城市:致命引擎
Bitter Harvest	烏克蘭悲歌
Something in the air	五月風暴
Photo Album of the Village	村之寫真集
...and LOVE	與愛
Bangkok Knockout	玩命KO
Blitz	私法制裁
Colic	卡到
Lost in Paradise	你是天堂愛是地獄
Poetry	生命之詩
Legend of Chinese Titans	封神傳奇
Precious	珍愛人生
An Inconvenient Sequel: Truth to Power	不願面對的真相2
Renegades	潛龍突擊隊
I Am Legend	我是傳奇
Meet the Fockers	門當父不對3
Tiger House	顫慄屋
Due West	一路向西
My King	我心深愛的國王
Enemy	雙面危敵
9 Songs	九歌
Bad Grandpa	無厘取鬧:祖孫卡好
The Descendants	繼承人生
The Boys Are Back	型男親情日記
The Eternal Zero	永遠的0
Nine	華麗年代
Rabbit Horror 3D	怨靈
Dynamite Warrior	功夫拳霸
47 Meters Down	深海鯊機
Shrew’s Nest	凌刑密密縫
The Bird Who Save The World	什麼鳥日子
クローズＺＥＲＯ II	漂丿男子漢2
Julie & Julia	美味關係
Dangal	我和我的冠軍女兒
3AM 3D Part 2	鬼三驚2
カメレオン	變色龍
Stronger	你是我的勇氣
Terminator: Genesis	魔鬼終結者5
Mandela: Long Walk to Freedom	曼德拉:漫漫自由路
X-Men: The New Mutants	變種人
9-9-81	陰緣
Someone You Love	最靠近心的距離
I Can Speak	花漾奶奶秀英文
The Coffin	棺材
The Days of Noah 2: Apocalypse	挪亞方舟驚世啟示2
Missing	謎屍
Kepong Gangster	甲洞
Love Songs	巴黎小情歌
Feast of Love	愛情盛宴
自虐の詩	自虐之詩
怪談	色凶怪談
Overdrive	盜速飛車
Blowflish	河豚
Miao Miao	渺渺
Haywire	即刻反擊
Alita: Battle Angel	艾莉塔:戰鬥天使
The Immigrant	浮世傷痕
1408	1408
Manglehorn	梅格漢的心靈鑰匙
Home Again	愛情齡距離
母べえ	X檔案:母親
The Promise	屍約
I Have to Buy New Shoes	巴黎鞋奏曲
My Sister, My Love	妹妹戀人
Vanishing on 7th Street	消失在第七大街
Lost in Beijing	蘋果
Confession of Murder	我是殺人犯
Winter's Bone	冰封之心
Cloudy with a Chance of Meatballs	食破天驚
Blue is the Warmest Color	藍色是最溫暖的顏色
Finding Sayun	不一樣的月光
Architecture 101	初戀築夢101
Sword Art Online the Movie: Ordinal Scale	刀劍神域劇場版－序列爭戰
Her Love Boils Bathwater	幸福湯屋
Spanish Movie	傻瓜大進擊
Phobia	鬼4虐
The Babadook	鬼敲門
The Last Painting	自畫像
Rise of the Legend	黃飛鴻之英雄有夢
The Possession of Emma Evans	惡靈附體
Tale of Tales	異色童話集
Peak: The Rescuers	岳：冰峰救援
War Machine	戰爭機器
National Treasure 2	國家寶藏2
Night Flight	愛,不怕
Wedding Daze	先婚後友
Carnage	今晚誰當家
7500	7500鬼航班
The Last Mistress	情慾二重奏
PK	來自星星的傻瓜
The Battleship Island	軍艦島
Song to Song	為妳唱的歌
Unlocked	全面封鎖
Harmony	美麗的聲音
Make Room	A片現場不NG
Secret	不能說的秘密
The Greatest Showman	大娛樂家
Spring Fever	春風沉醉的夜晚
Children Who Chase Lost Voices from Deep Below	追逐繁星的孩子
Before I Fall	還有機會說再見
Platinum Data	白金數據
Town Creek	鬼哭人嚎
Paranormal Activity: Tokyo Night	靈動2:東京實錄
We are What we are	屍房宴
The Incite Mill	七日死亡遊戲
The Belko Experiment	辦公室大狂殺
Hotaru the Movie: It's Only a Little Light in My Life	魚干女又怎樣
Four	鬼4厲
Juno	鴻孕當頭
Baby Driver	玩命再劫
Talaash	大搜索
Alone	連體陰
Dorothy Mills	附身
Knight of Cups	聖杯騎士
Holy Motors	花都魅影
Story of Taipei	台北物語
Sex & Chopsticks	金瓶梅
Kung-Fu Yoga	功夫瑜伽
Retribution	叫魂
Fist & Faith	青禾男高
Bittersweet	愛上有機男
Live Free or Die Hard	終極警探4
Point Blank	活命條件
Jack Ryan	傑克萊恩
The Romantics	浪漫愛婚頭
You Won’t Get to Live Twice	三個大丈夫
Saturno contro	熾愛
In a Better World	更好的世界
Detectivecconan：Sunflowes Of Inferno	名偵探柯南19
Des illusions	日落前與妳相遇
Timbuktu	在地圖結束的地方
Jump Ashin！	翻滾吧！阿信
Girls Trip	閨蜜假期
Dalida	絕代天后黛莉達
Men in the city 2	熱戀攻心
Forever Enthralled	梅蘭芳
No Reservations	料理絕配
The Fifth Element	第五元素
The Boss of It All	老闆我最大
Henry Poole is Here	上帝在我家
Were the World Mine	世界屬於我們
Tomb Raider	古墓奇兵
Jackie	第一夫人的秘密
Journey to the West: Conquering the Demons	西遊：降魔篇
A Dog's Purpose	為了與你相遇
Beyond Skyline	天劫:救贖之戰
Vampire Cleanup Department	救殭清道夫
Pay The Ghost	邪尋
The Fourth Portrait	第四張畫
Beauty and the Beast	新美女與野獸
Coco	可可夜總會
Goodbye Berlin	再見柏林
Exit Marrakech	流浪摩洛哥
Submarino	傷心潛水艇
The Last Face	戰地情
デトロイト・メタル・シティ	重金搖滾雙面人
White Lily	白百合之戀
シャカリキ！	鐵馬頑童
Silk	異旅情絲
WuKong	悟空傳
The Emoji Movie	表情符號電影
The Bar	抓狂酒吧
The Complex	黑百合公寓
Shao Lin	新少林寺
Ice kacang puppy love	初戀紅豆冰
The Man From U.N.C.L.E.	紳士密令
Insidious 4: The Last Key	陰兒房第4章
Smurfs: The Lost Village	藍色小精靈3
Rudolf the Black Cat	黑貓魯道夫
Vinodentro	魔鬼品酒師
The Ledge	窗台危機
Center of My World	我的觸男日記
Fantastic Four: Rise of The Silver Surfer	驚奇四超人2
Jurassic Park 3D	侏羅紀公園3D
A Walk in the Woods	別跟山過不去
A Quiet Place	噤界
Winds of September	九降風
Night Train to Lisbon	里斯本夜車
Her	雲端情人
Space Brothers	宇宙兄弟
The Book of Revelation	肉體性追緝
Microbe & Gasoline	青春冒險王
Vitus	想飛的鋼琴少年
Tiny Times	小時代
The Queen of Spain	天后開麥拉
Detective Dee	通天神探狄仁傑
Red Sparrow	紅雀
The Ghost Must Be Crazy	鬼也笑
Ocean Butterfly	蝴蝶魚
The Sinking City	西謊極落
The Tempests of First Love	初戀風暴
名探偵コナン漆黒の追跡者	名偵探柯南13
Ghost Rider: Spirit of Vengeance	惡靈戰警2
White Elephant	白象:無法之城
The Experiment	叛獄風雲
The Witnesses	愛滋味
The Second Chance	帶ㄙㄞˋ男朋友
The Hurt Locker	危機倒數
Bodybuilder	重量教育
Les aventures extraordinaires d'Adèle Blanc-Sec	神鬼驚奇
ハンサム★スーツ	帥哥西裝
The Tall Man	巨魔人
S.P.L.2	殺破狼2
Salmon Fishing in the Yemen	飄洋過海愛上妳
President	總統
Get Out	逃出絕命鎮
Attack on Titan：End of the World	進擊的巨人2
The Bad Lieutenant: Port of Call New Orleans	爆裂警官
The Apology King	謝罪大王
Le Week-End	愛在巴黎破曉時
Attraction	異星引力
A story about banana	香蕉傳奇
Cape No.7	海角七號
A.P.T	詭公寓
The Lego Ninjago Movie	樂高炫風忍者電影
Tomorrow I Will Date with Yesterday's You	明天，我要和昨天的妳約會
120 Beats Per Minute	120拍的節奏
Sister Smile	修女愛唱歌
映画ドラえもん　のび太と緑の巨人伝	大雄與綠巨人傳
Cash	至尊對決
Noriko's Dinner Table	紀子出租中
Beloved Sisters	二姊妹的情人
Empire State	帝國警戒
The Shape of Water	水底情深
Hearty Paws	伴我走天涯
What If	好友戀習簿
The Tale of the Princess Kaguya	輝耀姬物語
Taichi 0	太極
Battle of the Sexes	勝負反手拍
Bangkok Love Story	曼谷愛情故事
After the Wedding	婚禮之後
Red Road	紅路
Sector 7	7號禁地3D
The Third Half	人生勝利組
Comedy makes you cry	拍賣春天
20th Century Boys 3: Our Flag	20世紀少年3
Redline	超時空甩尾
西遊記之大鬧天宮	西遊記之大鬧天宮
The Survival Family	生存家族
Tarzan	泰山
Need For Speed	極速快感
Savage Grace	浮華陷阱
Rabbit Without Ears 2	沒有耳朵的兔子2
2002 The Unborn Child	鬼嬰廟
In His Chart 2	神的病歷簿2
Zombeavers	狸老屍卡好
The Bling Ring	星光大盜
Hummingbird	夜刑者
Stories We Tell	莎拉波莉家庭詩篇
Furious 8	玩命關頭8
3 Idiots	三個傻瓜
Margin Call	黑心交易員的告白
Albert Nobbs	變裝男侍
Back on Track	最後的馬拉松
Don't Knock Twice	別敲兩次門
Pecoross’ Mother And Her Days	去看小洋蔥媽媽
Fracture	破綻
Stranger by the Lake	湖畔春光
Dead Snow 2: Red vs. Dead	冰血奇緣
Tekkonkinkreet	惡童當街
The Ravine of Goodbye	再見溪谷
The Futute X-Cops	未來警察
Heartbeats	舞動心跳
Night of a 1000 Hours	風水逝家
Step Up All In	舞力全開5
Duckweed	乘風破浪
Hanky Panky	大釣哥
The Mysterous Family	神秘家族
Avengers: Infinity War	復仇者聯盟3
Winchester	溫徹斯特鬼屋
孤高のメス	孤高的手術刀
未來預想圖	未來預想圖
28 Weeks Later	28週毀滅倒數
Pirates of the Caribbean: Dead Men Tell No Tales	神鬼奇航5
Carrie Pilby	哈佛沒教的幸福課
Piranha 3-D	3D食人魚
Attack On Titan	進擊的巨人
Beyond the Walls	我們的幸福時光
Frozen River	冰原之心
One Piece Movie 3D Mugiwara Chase	航海王3D
Paradox	殺破狼•貪狼
Sex and the City: The Movie	慾望城市電影版
Of Gods and Men	人神之間
Kon-Tiki	康提基號
Old Dogs	歐吉桑卡好
NARA：奈良美智との旅の記録	跟著奈良美智去旅行
The Ghost Rituals	盂蘭神功
child 44	第44個孩子
Citizenfour	第四公民
Mood Indigo	泡沫人生
Clash	衝突的一天
Make Me Shudder 3	這個高中沒有鬼3
Ondine	情陷美人魚
Miss Sloane	攻敵必救
Hermano	你是我兄弟
Parasyte Part 1	寄生獸1
Full Speed	一路不順風
Fireworks, Should We See It from the Side or the Bottom?	煙花
Miss Meadows	甜心殺手
The Black Balloon	吾愛無悔
Young And Beautiful	美麗．誘惑
The World in Two Round Trips	小人物征服大世界
The Edge of Heaven	天堂邊緣
Lemon Tree	檸檬樹
The Evil in Us	命屍樂園
Chinese Puzzle	紐約愛情拼圖
Human Capital	人命大富翁
Roommate	我的恐怖室友
The intruder	蛇降
Frantz	雙面法蘭茲
ぼくたちと駐在さんの700日戦争	我和條子的700天戰爭
The Pain of Others	海巡尖兵
Mr. Bean's Holiday	豆豆假期
Child’s Pose	愛的佔有慾
The Lazarus Project	撕裂記憶體
From a House on Willow Street	綁的不是人
A River Runs Through It	大河戀
Queens	我的酷兒婚禮
The Ghost Tale	變羊記
Greenberg	愛上草食男
The Human Centipede	人形蜈蚣
What Love May Bring	情海浮生錄
The Good, the Bad and the Weird	神偷獵人斷指客
Tears of April	四月情塚
Agora	風暴佳人
The New Girlfriend	女朋友的女朋友
Tales of Halloween	萬聖夜怪譚
The Great Beauty	絕美之城
Partners in Crime	共犯
One Chance	翻聲吧保羅
Maiko Haaaan	舞妓哈哈哈
MICHAEL H. Prefession : Director	漢內克的導演秘密
Ninja Turtles	忍者龜
December Boys	十二月的男孩
Sex, Party and Lies	謊言性派對
Oba: The Last Samurai	太平洋的奇蹟
ROOKIES -卒業-	菜鳥總動員電影版
My Old Lady	巴黎窈窕熟女
The Warrior and the Wolf	狼災記
Perfect Mothers	愛墮落
Tour de Force	騎動人生
The Last Word	她其實沒那麼壞
My Blind Date With Life	看見5%的奇蹟
Rise: Blood Hunter	獵殺鬼世界
Pee Mak Phrakanong	淒厲人妻
It	牠
Rainbow Fireflies	彩虹螢火蟲
Spell	屍油
Manchester by the Sea	海邊的曼徹斯特
All’s Well, Ends Well 2012	八星抱喜
Lilting	輕輕搖晃
キセキ -あの日のソビト-	唱吧!奇蹟!
The Swimmers	水男骸
Eating Out: Drama Camp	外出用餐4
Out of the Dark	童靈眼
Whatever Works	紐約遇到愛
Cha Cha for Twins	寶米恰恰
Where Got Ghost	嚇到笑
イキガミ	死亡預告
Nightwatching	夜巡林布蘭
Sadako 3D 2	貞子3D2
Wonder Wheel	愛情摩天輪
Bahubali 2: The Conclusion	巴霍巴利王2
My Brother Is An Only Child	我哥哥是獨生子
Smuggler	搬運你的未來
Oz: The Great and Powerful	奧茲大帝
Big Game	總統遊戲
Isle of Dogs	犬之島
A Taxi Driver	計程車司機
Summer’s Tail	夏天的尾巴
Sadako 3D	貞子3D
Sound of Noise	噪反城市
Confessions	告白
喜羊羊與灰太狼之虎虎生威	喜羊羊與灰太狼
Net I Die, Drop dead gorgeous	魍美
Inside Llewyn Davis	醉鄉民謠
Caesar Must Die	凱薩必須死
Chaotic Ana	安娜床上之島
Resident Evil: The Final Chapter	惡靈古堡6
That Summer	偷歡
The Orphanage	靈異孤兒院
One Piece Film Z	航海王電影：Z
Beyond Beauty - Taiwan from Above	看見台灣
A Few Hours of Spring	春日光景
Cool Ma	酷馬
Transformers 4	變形金剛4
Butterfly on a Wheel	贖命24小時
Vow of death	求神問鬼
DIVE!!　ダイブ!!	跳水男孩
21 Jump Street 2	龍虎少年隊2
The Lego Batman Movie	樂高蝙蝠俠電影
Father’s Lullaby	手機裡的眼淚
Transformers: The Last Knight	變形金剛5
Eating Out: The Open Weekend	外出用餐5
Alvin and the Chipmunks	鼠來寶
The Brain Man	腦男
Love Strikes!	草食男之桃花期
Samba	巴黎遇見愛
Gattu	風箏孩子王
George A. Romero Survival of the Dead	活死人之島
Breathe	我要為你呼吸
Small Talk	日常對話
My Mom's New Boyfriend	我媽的新男友
Solomon Kane	所羅門傳奇
The Double	盜貼人生
Attitude :The Movie	態度
Moana	海洋奇緣
Molly's Game	決勝女王
劇場版 黒子のバスケ LAST GAME	影子籃球員
Fish Tank	發現心節奏
The Tribe	過於寂靜的喧囂
KIDS	超感應
The Beguiled	魅惑
Hannah Montana & Miley Cyrus: Best of Both Worlds Concert Tour	孟漢娜3D演唱會
Tomorrow when the war began	破曉開戰
Everything Must Go	拍賣人生
A Little Chaos	美人情園
Peanuts	史努比
Code Name: The Cleaner	霹靂鳥探
火垂るの墓	螢火蟲之墓
Invictus	打不倒的勇者
Mae Bia	蛇姬:極樂誘惑
Younger Brother	春之櫻
Fraulein	三十而麗
GATAO 2	角頭2:王者再起
Mr. Go	王牌巨猩
In Order of Disappearance	該死的順序
Love,Rosie	真愛繞圈圈
Cherry Blossoms	當櫻花盛開
Beaufort	前陷風暴
Dunkirk	敦克爾克大行動
僕の彼女はサイボーグ	我的機器人女友
Thanks for Sharing	謝謝分享,我的愛
Flatliners	別闖陰陽界
The Zookeeper's Wife	園長夫人:動物園的奇蹟
Ju-on: The Beginning of the End	咒怨:終結的開始
Detective Conan : Private Eye In The Distant Sea	名偵探柯南17
Beauty and the Beast 3D	美女與野獸3D
Xenia	我的希臘甜心
Memory	靈虐
The Woodsman and the Rain	啄木鳥與雨
エクスクロス　魔境伝説	活人祭
Villain	惡人
Chronicle of My Mother	我的母親手記
The Autopsy of Jane Doe	驗屍官
Cold Bloom	愛在櫻花紛飛時
Survivor	倒數行動
Grand Central	愛慾來襲時
Obsessed	人間中毒
踊る大捜査線　THE MOVIE３	大搜查線3
Robot Overlords	鋼鐵叛軍
Three Kingdoms: Resurrection of the Dragon	三國之見龍卸甲
Ocean Flame	一半海水,一半火焰
Sex duties unit	飛虎出征
Uncle Boonmee Who Can Recall His Past Lives	波米叔叔的前世今生
Attack the Block	異星大作戰
The Sense of an Ending	回憶的餘燼
War Witch	愛在戰火迷亂時
I Just Didn't Do It	嫌豬手事件簿
Ladda Land	陰地
Mary & Max	巧克力情緣
The Mimic	仿聲靈
The Only Living Boy in New York	紐約寂寞男孩
Searching For Sugar Man	尋找甜秘客
Starfish	我的海星爸爸
Fifty Shades Freed	格雷的五十道陰影3
Amour Legende	松鼠自殺事件
Heart of Stone	心之物語
Live by Night	夜行人生
What We Do In The Shadows	吸血鬼家庭屍篇
Patriots Day	愛國者行動
Take the A Train	幸福特快車
The Postman's White Nights	郵差的白色夜晚
Beyond the Arctic	征服北極
Breath	窒息情慾
Geostorm	氣象戰
Alien Abduction	詭影訪客
Heaven and Hell	監屍器
Fly Me to the Moon	真愛找冤家
Gerald's Game	傑羅德遊戲
Coming In	歡迎光臨愛情沙龍
The Sleep Curse	失眠
Love is sin	白天的星星
Vengeance	邪靈復仇
The Cove	血色海灣
The Descent: Part 2	深入絕地2
Norbit	糯米正傳
Parking	停車
The Bélier Family	貝禮一家
The Sky Crawlers	空中殺手
The Tag-Along 2	紅衣小女孩2
The Ghost Writer	獵殺幽靈寫手
House of Lies	謊言對決
Shooter	狙擊生死線
When Marnie Was There	回憶中的瑪妮
This is not what I expected	喜歡你
Monsieur Lazhar	再見了,拉札老師
Fathers and Daughters	幸福再敲門
Summer Rain	夏季雨
Tom of Finland	芬蘭湯姆
Doraemon the Movie: Nobita and the Island of Miracle	哆啦A夢
Spanish Affair	風流西班牙
Smallfoot	小腳怪
A Better Tomorrow	英雄本色
The Last Flight	北非謎情
Knocked Up	好孕臨門
少年メリケンサック	少年手指虎
Before I go to sleep	別相信任何人
6 Below	我要活下去
SP 野望篇	型男特警:野望篇
The Children of Huang Shi	黃石任務
Harry Potter and the Order of the Phoenix	哈利波特6
3AM	鬼三驚
X+Y	愛的方程式
The Big Gay Musical	超級同志音樂會
Darkest Hour	最黑暗的時刻
Detroit	底特律
P.S. I Love You	PS.我愛妳
Battle Up！	舞鬥
Adiantum Blue	鐵線蕨的憂鬱
Mother of Tears	木乃伊博物館
Life As We Know It	命中注定多個你
Outside The Law	光榮時刻
The Congress	虛擬天后
Hellboy 2	地獄怪客2
The Club	贖罪俱樂部
Ana, Mon Amour	我為愛
Guilty of Romance	戀之罪
Rail Truck	軌道
The Flying Swords of Dragon Gate	3D龍門飛甲
Honnouji Hotel	本能寺大飯店
The Treacherous	姦臣:色誘天下
Mark Felt: The Man Who Brought Down the White House	推倒白宮的男人
Make Me Shudder	這個高中沒有鬼
Mother's Day	母親劫
The Big Sick	愛情昏迷中
Outsourced	世界是平的
Oh Boy	噢！柏林男孩
The Storm	昨天再見
ゲゲゲの鬼太郎	鬼太郎
Brain on Fire	我發瘋的那段日子
American Assassin	美國刺客
Sons of Norway	搖擺天體營
God man dog	流浪神狗人
12 Strong	12猛漢
Step Up 4	舞力全開4
Visions	冥視
App	手機有鬼
Gulf Stream Under the Iceberg	性愛慾3世紀
ノルウェイの森	挪威的森林
The Page Turner	琴謎變奏曲
Still 2	凶地
ハナミズキ	花水木
The Water Horse: Legend of the Deep	尼斯湖水怪
All Because Of Love	痴情男子漢
Spring Breakers	放浪青春
Headshot	迎頭重擊
On the Road	浪蕩世代
Starlit High Noon	日正當中的星空
The Man from Nowhere	大叔
Their Finest	他們的美好時光
House At The End of the Street	地下弒
The Con Artists	技術者們
Coursier	終極快遞
A Story of Yonosuke	横道世之介
The Hole in 3D	3D無底洞
The Sorcerer and the White Snake	法海:白蛇傳說
Sex Doll	玩物戀人
The King	金權性內幕
Broken Embraces	破碎的擁抱
Notte prima degli esami - Oggi	2008新畢業生
The Assassination of Jesse James by the Coward Robert Ford	刺殺傑西
Trivial Matters	破事兒
Pale Moon	紙之月
We Own the Night	萬惡夜總會
Simple Simon	阿蒙正傳
Enter the Void	嗑到荼蘼
Only God Forgives	罪無可赦
The Princess of Montpensier	公主和她的情人
With Love... from the Age of Reason	給未來的我
The Devil Inside	心魔
Amour	愛•慕
Certified Copy	愛情對白
Waltz for Monica	給莫妮卡的華爾滋
Sisterhood	骨妹
Diana	黛安娜
Marina Abramovic: The Artist Is Present	凝視瑪莉娜
Logan Lucky	羅根好好運
Din Tao：Leader of the Parade	陣頭
Black & White Episode 2	痞子英雄2
Ma' Rosa	私法拘留
The Glass Castle	玻璃城堡
Allied	同盟鶼鰈
Insidious Chapter 3	陰兒房3
The Burning Plain	燃燒的原野
Kidnap	綁架
Oslo, 31. august	八月三十一日,我在奧斯陸
The Receptionist	接線員
1987: When The Day Comes	1987：黎明到來的那一天
Robot & Frank	機器人與法蘭克
[REC] 4: Apocalipsis	錄到鬼4
Liberal Arts	愛情必修學
Kong: Skull Island	金剛:骷髏島
Leo's Room	里歐的房間
Comet Impact	2008隕石噩夢
Le Havre	溫心港灣
Three Monkeys	三隻猴子
I Served the King of England	我曾伺候過英國國王
The Hitman’s Bodyguard	殺手保鑣
The Crocodiles	少年鱷魚幫
[REC] 3: Genesis	錄到鬼3
Phantom of the Opera at the Royal Albert Hall	歌劇魅影舞台版
White God	忠犬追殺令
崖の上のポニョ	崖上的波妞
Kill Your Darlings	愛殺達令
The Villainess	惡女
All's Well Ends Well 2011	最強囍事
Inside	鮮胎活剝
Buddha: The Great Departure	佛陀：首部曲
Alien: Covenant	異形:聖約
Heli	毒粉風暴
Did You Hear About the Morgans?	名牌冤家
Nobody’s Perfect	沒問題三班
The Wall	危牆狙擊
Night at the Museum 3	博物館驚魂夜3
Sand Clock	砂時計
The Transporter Legacy	玩命快遞4
Black Book	黑書
Thermae Romae II	羅馬浴場2
If Not Us, Who?	捨愛其誰
Neko Atsume House	貓咪收集之家
The Penguins of Madagascar	馬達加斯加爆走企鵝
labor day	一日一生
Allacciate Le Cinture	愛情初邂逅
The Kite Runner	追風箏的孩子
Dear Friends ディア フレンズ	二分之ㄧ的友情
Suck Me Shakespeer	不良鮮師
The Haunted Drum	人頭蠱
The Crossing Part 2	太平輪:驚濤摯愛
Despicable Me 3	神偷奶爸3
Okja	玉子
Jobs	賈伯斯
Two Days, One Night	兩天一夜
蛇にピアス	蛇信與舌環
Beasts of the Southern Wild	南方野獸樂園
Gifted	天才的禮物
Shrek the Third	史瑞克三世
Babysitting	褓姆Hold不住
クロサギ	詐欺獵人
Cooties	殭屍小屁孩
Dead in 3 Days	活三更
Le Grand Chef	食客
G.I. Joe 2: Retaliation	特種部隊2
A Werewolf Boy	狼少年
The Post	郵報:密戰
Coco Chanel & Igor Stravinsky	香奈兒的秘密
Initiation Love	愛的成人式
The Broken Circle Breakdown	愛的餘燼
My DNA Says I LoveYou	基因決定我愛你
Heroes Wanted	魯蛇特攻隊
戰爭製造公司	戰爭製造公司
After Lucia	露西亞離開之後
Hachiko: A Dog's Story	忠犬小八
Nymphomaniac	性愛成癮的女人
Pink & Gray	紅的告別式
Cheers from Heaven	來自天國的喝采
Jack the Giant Killer	傑克:巨人戰
You're The Apple Of My Eye	那些年,我們一起追的女孩
Melancholia	驚悚末日
The Wonders	蜂蜜之夏
My back page	革命青春
Vacancy	針孔旅社
And If We All Lived Together	六人行不行
xXx: The Return of Xander Cage	限制級戰警3
My Rainy Days	天使之戀
Natalie	娜妲莉的情人
Gone for a Dance	花漾漫舞
The Search for General Tso	尋找左宗棠
The Pirates	海賊：汪洋爭霸
My Brilliant Life	噗通噗通我的人生
The Go-Go Boys	電影狂人夢
Cosmopolis	夢遊大都會
Ballerina	芭蕾奇緣
Una	最愛你的人是我
Nobody Else But You	夢露謎情
Another Gay Movie	酷兒同玩派
Return to Sender	控制遊戲
About Ray	幸福不設限
Radin !	金金計較
Martian Child	我的火星小孩
Air Doll	空氣人形
To Each His Own	不幹了！我開除了黑心公司
Our Little Sister	海街日記
Gallows Hill	闇魔怨
Epitaph	冥婚淒談
Rock'n Roll	搖滾救明星
The Railway Man	心靈勇者
Conan the Barbarian	王者之劍3D
Angel's Egg	天使之卵
James Cameron's Deepsea Challenge 3D	深海挑戰3D
Beyond the Gates	勇闖地獄門
Nanking	被遺忘的1937
Out in the Dark	愛,悄悄越界
Pitch Perfect 3	歌喉讚3
The Maze Runner: The Scorch Trials	移動迷宮2
The Detcctive 2	B+偵探
Mayday 3DNA	五月天追夢
Marie Antoinette	凡爾賽拜金女
3D Sex & Zen: Extreme Ecstasy	3D肉蒲團
The Housemaid	下女
Ghost Graduation	死也要畢業
Messi	球神梅西
容疑者Ｘの献身	嫌疑犯X的獻身
Will You Still Love Me Tomorrow？	明天記得愛上我
Ocean's 8	瞞天過海:八面玲瓏
Connected	保持通話
Pacific Rim: Uprising	環太平洋2
Land of Mine	拆彈少年
Wu xia	武俠
Living The Game	我在快打求旋風
Words and Pictures	字畫情緣
The Divide	崩裂:毀滅殺陣
Doraemon The Movie 30th	大雄的人魚大海戰
Schoolgirl Complex	私處
Bee Movie	蜂電影
Split	分裂
Elizabeth: The Golden Age	輝煌年代
Omar	奧瑪的抉擇
Sex and Death 101	101夜情
Still Alice	我想念我自己
The Great Buddha +	大佛普拉斯
Umizaru 3: The Last Message	海猿3D
Wind River	極地追擊
The Founder	速食遊戲
Harry Potter and the Deathly Hallows - Part 1	哈利波特7
The Crucifixion	刑弒厲
Life, Animated	動畫人生
Burying the Ex	我的屍控女友
Power Rangers	金剛戰士
Grand Piano	關鍵琴聲
The Refuge	逐愛角落
Cheap Thrills	絕命賭局
City Without Baseball	無野之城
In the Name of the King: A Dungeon Siege Tale	末日危城
Eastern Promises	黑幕謎情
From Beginning to End	兄弟情人
犬と私の10の約束	與狗狗的十個約定
Wonder	奇蹟男孩
Naked Harbour	縱情城市
The Numbers Station	數字戰
Sorry I Want to Marry You	愛妳衝婚頭
Lights in the Dusk	薄暮之光
John Wick 2	捍衛任務2
The Cobbler	命運鞋奏曲
2 Days in Paris	巴黎二日情
A Pierrot	重力小丑
The Disaster Artist	大災難家
What We Did on Our Holiday	這個夏天的秘密
The Last Chance: Diary of Comedians	我們的交換日記
Elephant Song	憂傷大象之歌
Empties	布拉格練習曲
Les Miserables	悲慘世界
I Give My First Love to You	我的初戀情人
Didi's Dream	吃吃的愛
What Maisie Knew	梅西的世界
StreetDance 3D	3D舞力對決
Vincent and the end of the world	少年文森的瘋狂世界
Downsizing	縮小人生
Holiday	逃獄風雲
Wild Mouse	放生員工請注意
Whip It	飆速青春
The Passionate Life of Edith Piaf	玫瑰人生
Jungle	逃出亞馬遜
Echoes Of The Rainbow	歲月神偷
Black Butler - Book of the Atlantic	黑執事劇場版
The Billionaire	海苔億萬富翁
Sasha	第一次心動
The Good Guy	尋找完美情人
The Drudgery Train	苦役列車
Shanghai	上海
Red Like The Sky	聽見天堂
Solanin	手拉你
Secret Sharer	海上情謎
Romulus, My Father	我的父親魯木斯
Twice Born	摯愛永恆
劇場版 FAIRY TAIL -DRAGON CRY	魔導少年:龍之淚
From Up On Poppy Hill	來自紅花坂
Oshin	阿信
Phantom Thread	霓裳魅影
Banlieue 13: Ultimatum	暴力特區2
The Fantastic Four	驚奇4超人
Bad Genius	模犯生
The Girlfriend Experience	應召女友
Death Note	死亡筆記本
Hunting and Gathering	巴黎夜未眠
Video Clip	駭人手機
Underworld 4	決戰異世界4
クレヨンしんちゃん　超時空！嵐を呼ぶオラの花嫁	蠟筆小新
The Mummy	神鬼傳奇
The Flight of the Red Balloon	紅氣球
This is Where I Leave You	愛在頭七天
心が叫びたがってるんだ	好想大聲
Walking on Sunshine	舞力假期
Dark Flight 3D	3D鬼機8
Jurassic World: Fallen Kingdom	侏羅紀世界2
Stratton	金牌特勤
Train of the Dead	猛鬼列車
Birthday Card	生日卡片
Brasserie Romantiek	羅曼蒂克大飯店
Capital	資本遊戲
Girls 2	閨蜜2
Vicky Cristina Barcelona	情遇巴塞隆納
Monsterz	超能對決
Cheri	真愛初體驗
Ju-on: the Final Curse	咒怨:最終章
The Forger	驚世劫作
The Venice Syndrome	威尼斯我愛你
Loose Cannons	愛情流彈
A Separation	分居風暴
Under the Skin	肌膚之侵
Machine Gun Preacher	重裝教士
Atomic Blonde	極凍之城
TOKYO !	東京狂想曲
The Sun Also Rises	太陽照常升起
Salt and Fire	鹽與火之歌
Frances Ha	紐約哈哈哈
Dragon Hunter	捉龍特攻隊
Legend of the Guardians	貓頭鷹守護神
名探偵コナン　天空の難破船	名偵探柯南14
Angels & Demons	天使與魔鬼
The Concert	交響人生
White Bird in a Blizzard	暴風雪中的白鳥
Tekken: Blood Vengeance	鐵拳:血之復仇
Vincent Wants To Sea	文生去看海
She's Out of My League	辣妹愛宅男
Mrs. Ratcliffe's Revolution	老娘鬧革命
Sweet Home	屠屍館
Stopped on Track	瀕臨邊緣的人
Ghost House	猛鬼抓交替
HK: Forbidden Super Hero	瘋狂假面
Happy Feet Two	快樂腳2
Big Miracle	鯨奇之旅
The Hottie & the Nottie	愛上野豬妹
Sex & Chopsticks 2	金瓶梅2
Rough Night	女狼嗨到趴
Reprise	愛重奏
What The Snow Brings	向雪許願
Guardians of the Galaxy Vol. 2	星際異攻隊2
Birds Without Names	她不知道
Hours	搏命關頭
The Home Song Stories	意
LOL	巴黎LOL
How I Ended This Summer	我如何度過這個夏天
The Captive	雪地迷蹤
Bait 3D	大海嘯鯊口逃生
Sleeping With Other People	愛睡在一起
King Arthur: Legend of the Sword	亞瑟:王者之劍
A Woman Goes to the Doctor	陪妳到最後
Keep Running! Sir, Yes Sir!	誰說軍中沒有鬼
The Way, Way Back	三分男孩
Welcome to Germany	歡迎來住我家
Hui Buh: The Castle Ghost	瘋狂鬼幽靈
Justice League	正義聯盟
Team Spirit	巴黎交易員
The Disappearance of Eleanor Rigby	因為愛情
A Silent Voice	電影版聲之形
The Twilight Saga: Breaking Dawn - Part 2	暮光之城4:破曉Ⅱ
The Bourne Ultimatum	神鬼認證3
CJ7	長江七號
Flying Butterfly	蝴蝶飛
Prayers for Bobby	為巴比祈禱
Perfect Stranger	勾引陌生人
Summer Palace	頤和園
Bright Star	璀璨情詩
Delicacy	愛情好意外
Escape Room	密弒逃脫
Now is Good	愛正好
Safe	火線反擊
Besieged City	圍城
Inhumans	異人族
Gatao	角頭
あたしンち　情熱のちょ∼超能力♪母 大暴走	超能力花媽
The Measure of a Man	衡量一個人
名探偵コナン　戦慄の楽譜	名偵探柯南12
SuckSeed	音為愛
The Riot Club	高富帥俱樂部
Run Papa Run	一個好爸爸
Cruel & Unusual	迴路人生
CARS 3	汽車總動員3
Dare	愛我敢不敢
Chocolate	致命巧克力
Annihilation	滅絕
The Gangster's Daughter	林北小舞
続・三丁目の夕日	再續幸福的三丁目
Sleuth	非常衝突
Journey 3-D	3D地心冒險
Like Father, Like Son	我的意外爸爸
The LEGO Movie	樂高玩電影
Love Contractually	合約男女
Formosa Betrayed	被出賣的台灣
The Simpsons Movie	辛普森家庭電影版
39 Pounds of Love	39磅的愛
Roaring Currents	鳴梁:怒海交鋒
The Village Of No Return	健忘村
Mr. Magorium's Wonder Emporium	魔法玩具城
Brave Hearts: Umizaru	海猿4:終極救援
Murder on the Orient Express	東方快車謀殺案
Sick Nurses	恐怖護理站
Rock On	實習大明星
Bangkok Traffic (Love) Story	下一站說愛你
Elle	她的危險遊戲
Orange Love	愛情公寓
Kung Fu Dunk	功夫灌籃
Late Bloomers	內衣小舖
The Double Lover	雙面愛人
The Dark Is Rising	黑紀元
Pet	寵物情劫
My House	鬼地方
Colossal	柯羅索巨獸
Stars are born	星光傳奇
Eloise	療養怨
My Little Pony: The Movie	彩虹小馬大電影
Maze Runner: The Death Cure	移動迷宮3
The Dark Tower	黑塔
Hansel and Gretel: Witch Hunters	女巫獵人
Miss Pettigrew Lives for a Day	B咖妙管家
Saying good-bye, oneday	再見總有一天
At Any Price	玩命代價
奇妙的旅程	奇妙的旅程
Detective Conan Episode One	變小的名偵探
Long Weekend	陰巢
Captain Fantastic	神奇大隊長
One Week Friends	一週的朋友
Gantz	殺戮都市
London Boulevard	倫敦大道
Headhunters	獵頭遊戲
The 100th Love with You	與妳的第100次愛戀
The Grandmasters	一代宗師
Rebirth	第八日的蟬
To Sir, With Love	卸屍宴
The Bye Bye Man	冤親債主
Then She Found Me	再給愛一次機會
A Dangerous Method	危險療程
The Little Prince	小王子
Hide And Never Seek	厄夜直播
The Green Inferno	食人煉獄
Jack Reacher	神隱任務
The Sacrament	生人活祭
Emma’s Bliss	艾瑪的禮物
The Mutant Chronicles	突變末日
A Little Bit of Heaven	想愛趁現在
Sergeant Keroro the Movie 2	軍曹超劇場版2
Happy Death Day	忌日快樂
Baby Bumps	辣媽好孕到
Annabelle 2	安娜貝爾2
War of the Arrows	弓箭之戰
The Foreigner	英倫對決
Sky of Love	戀空
Ilo Ilo	爸媽不在家
The Unknown Woman	裸愛
My Awkward Sexual Adventure	我的性愛六堂課
The Bloom of Yesterday	昨日盛開的花朵
Sex, Love & Therapy	性愛診療室
Twa-tiu-tiann	大稻埕
Countdown	倒數夜驚魂
Genova	情留吉諾瓦
Fire With Fire	封火線
Hector and the search for happiness	尋找快樂的15種方法
The Green Prince	哈瑪斯之子
Happy Few	你快樂所以我快樂
The Kirishima Thing	聽說桐島退社了
ゲゲゲの鬼太郎 千年呪い歌	鬼太郎2
マリと子犬の物語	心動奇蹟
Lady Chatterley	查泰萊夫人
Earth	我們的地球
Free Fire	玩命鎗火
Italian Race	少女車神
Quartet	唱快人生
Shelter	藏身處
The Invasion	恐怖拜訪
Bushwick	全境警戒
Still Life	無人出席的告別式
To Rome with Love	愛上羅馬
Elite Squad	精銳部隊
Corrections Class	廢青同盟
The Space Between Us	愛上火星男孩
Room in Rome	羅馬慾樂園
Cloudy With a Chance of Meatballs 2	食破天驚2
The Empress And The Warriors	江山美人
Good Kill	巡弋狙擊手
Estômago	刑男大主廚
Drive Angry 3D	3D怒火狂飆
Tokyo Ghoul	東京喰種
The Boy and The Beast	怪物的孩子
ブタがいた教室	和豬豬一起上課
I Kissed a Girl	新郎嫁錯郎
Suite Francaise	亂世有情天
Untamed	慾望
Brad's Status	人生剩利組
The Spirit	閃靈俠
Daddy's Home 2	家有兩個爸2
A Cure For Wellness	救命解藥
100 metros	100公尺的人生
Camille Rewinds	再一次初戀
The Best Exotic Marigold Hotel	金盞花大酒店
Street Dance 2	3D舞力對決2
Waz	要命法則
Nebraska	內布拉斯加
Angel	逐愛天堂
The Humbling	百老匯熟男日記
The Hairy Tooth Fairy	金鑚鼠王
Castaway on the Moon	荒島愛
There Will Be Blood	黑金企業
Life of Crime	百萬嬌妻綁架計畫
Memories of My Melancholy Whores	我的鬱妓回憶錄
Before the Devil Knows You're Dead	魔鬼知道你死前
Japanese Salaryman NEO	菜鳥薪鮮人
The Bubble	泡泡公寓四人行
My Blueberry Nights	我的藍莓夜
Brave Story	勇者物語
Rise of the Apes	猩球崛起
Hercules 3D	鋼鐵力士
Sorry If I Love You	熟男我愛你
花より男子ファイナル	流星花園
創造宇宙壽司男	創造宇宙壽司男
Patrik Age 1.5	派翠克一歲半
Red Sky	殲滅天際線
Happy together-all about my dog	狗狗當家
Welcome	愛的自由式
Make Me Shudder 2	這個高中沒有鬼2
Summer Wars	夏日大作戰
In This Corner of the World	謝謝你,在世界的角落找到我
Collide	偷天劫車手
Pirates of the Caribbean: At Worlds End	神鬼奇航3
She’s funny that way	百老匯風流記
Wish Upon	奪命潘朵拉
南風（なんぷう）	南風
Renoir	印象雷諾瓦
Easy Virtue	愛,隨心所欲
愛在愛情空窗期	愛在愛情空窗期
My Ex 2: Haunted Lover	鬼陰驚
The 33	33:重生奇蹟
Say Yes	101次求婚
Jan Dara: The finale	晚孃下部:罪色
American Gangster	美國
Viking	維京傳說:寒冰交鋒
Cave of Forgotten Dreams	3D祕境夢遊
The Florida Project	歡迎光臨奇幻城堡
Zero Dark Thirty	00:30凌晨密令
The Lost City of Z	失落之城
Hidden Diary	隱藏日記本
The Kid with a Bike	騎單車的男孩
Titanic 3D	鐵達尼號3D版
The Mountain Between Us	絕處逢山
The Ten	愛情十賤事
The Beautiful Person	巴黎小情人
August Rush	把愛找回來
Tenchi: The Samurai Astronomer	天地明察
Arctic Tale	極地熊寶貝
Irreplaceable	小鎮醫生
Hairspray	髮膠明星夢
The Adventurers	俠盜聯盟
Eat, Pray, Love	一個人的旅行
All The Money In The World	金錢世界
Fifty Shades Darker	格雷的五十道陰影2
Red Lights	第7度感應
Goodbye Bafana	再見曼德拉
百萬殺人實驗	百萬殺人實驗
Golden Chickens	金雞SSS
Twentieth Century Boys	二十世紀少年
Sicario 2: Soldado	怒火邊界2
Force Majeure	婚姻風暴
分手說愛你	分手說愛你
Once in a Blue Moon	鬼壓床了沒
Boys	田徑男孩
Black Panther	黑豹
Bus 657	關鍵救援:巴士657
釣りキチ三平	天才小釣手
I Killed My Mother	聽媽媽的話
Avatar	阿凡達:特別版
Harry Potter and the Deathly Hallows - Part 2	哈利波特7.2
Moratorium Tamako	青春,半生不熟
The Snow White Murder Case	白雪公主殺人事件
Full Treatment	愛神來了怎知道
Welcome To Yesterday	跨界失控
In the Valley of Elah	震撼效應
Star Wars: Episode I The Phantom Menace 3D	星際大戰:威脅潛伏3D
Take Shelter	歷劫重生
The Commuter	疾速救援
Detective Conan: The Sniper from Another Dimension	名偵探柯南18
Dogtooth	非普通教慾
Bordertown	亡命殺鎮
Home: Love, Happiness, Remembrance	擁抱幸福擁抱愛
Sea Fog	海霧
Again	青春殘愛物語
Sunshine on Leith	愛在陽光燦爛時
Marvel Stories	漫威:超級英雄王國
The Lovely Bones	蘇西的世界
Don’t go breaking my heart	單身男女
House of Pleasures	巴黎妓院回憶錄
Mother!	母親!
Ace Attorney	逆轉裁判
Rurouni Kenshin	神劍闖江湖
Tales from the Dark	鬼夜
Len and Company	搖滾不靠爸
Heartbreaker	戀愛救火隊
The Flowers of War	金陵十三釵
Project Hashima	鬼城
30 Days of Night	貝武夫:夜三十
Alvin and the Chipmunks: The Squeakuel	鼠來寶2
Away We Go	房事告急
Gnomeo & Juliet	糯米歐與茱麗葉
Valerian and the City of a Thousand Planets	千星之城
Dorian Gray	美少年格雷的畫像
The Diving Bell and the Butterfly	潛水鐘與蝴蝶
Swinger	愛愛大風吹
Lovelace	A片女神
Tom at the Farm	湯姆在農莊
Hip-hop Storm	街舞
The Zero Theorem	明日定律
Remember	我記得
The Teacher	老師有問題
Michael Kohlhaas	最後的正義
Ah Boys to Men	新兵正傳
Finishing the Game	非關英雄
Special Forces	沙漠神兵
Glory to the Filmmaker	導演萬歲
Adieu Paris	人約巴黎
The Maid	女僕
License to Wed	結婚糾察隊
Third Person	情慾三重奏
Keep The Lights On	為你流的淚
Ferdinand	萌牛費迪南
The Eyes Diary	彎道鬼情人
The Piano In A Factory	鋼的琴
Red Cliff	赤壁
Three Billboards Outside Ebbing, Missouri	意外
Exte: Hair Extensions	美髮屍
The Babysitter	辣手保姆
大決戦！超ウルトラ８兄弟	超鹹蛋超人8兄弟
Who Killed Cock Robin	目擊者
Bachelorette	伴娘Hold不住
Closest Love to Heaven	今天的吉良同學
Regression	邪靈刑事錄
Dawn of the Felines	母貓
Speed Master	極速狂飆
The Sentiment of the Flesh	情慾內視鏡
The Skin I Live In	切膚慾謀
Half Nelson	我的左派老師
Gukoroku-Traces of Sin	愚行錄
Perfect Sense	末日情緣
Goya's Ghosts	哥雅畫作下的女孩
Jesus Loves Me	天神愛光臨
Only Lovers Left Alive	噬血戀人
The Wings of the Kirin	麒麟之翼
Silver Linings Playbook	派特的幸福劇本
The Angels' Share	天使威士忌
No Breathing	屏息
Dragon Ball Z: Battle of Gods	七龍珠Z劇場版
The Girl Who Played with Fire	玩火的女孩
Gatchaman	科學小飛俠
The Lion King 3D	獅子王3D
Legend of Sudsakorn	聖麒麟傳說
Love Off the Cuff	春嬌救志明
Help Me Eros	幫幫我愛神
A Family Man	愛在回家時
Detachment	人間師格
Maps to the Stars	寂寞星圖
The Game Plan	超級盃奶爸
The Blind Side	攻其不備
Ways to Live Forever	永遠在一起
Resident Evil: Vendetta	惡靈古堡:血仇
Persepolis	茉莉人生
Parkland	關鍵目擊
Thermae Romae	羅馬浴場
The Collector	蒐屍魔前傳
The Flock	屍蹤現場
La Danse: The Paris Opera Ballet	舞動芭黎,掌聲蕾動
Pride	驕傲大聯盟
The Bad Batch	生存者
Let the Bullets Fly	讓子彈飛
安娜卡列妮娜	安娜卡列尼娜
The Snowman	雪人
The Salt of the Earth	薩爾加多的凝視
The warloads	投名狀
Chatroom	聊天弒
Insidious Chapter 2	陰兒房2
King of Devil's Island	我的青春煉獄
I Give It a Year	一年之癢
Dracula Untold	德古拉:永咒傳奇
Rings	七夜怪譚
Ajami	遠離阿雅米
Closing the Ring	戒情人
Call Me by Your Name	以你的名字呼喚我
We Need to Talk About Kevin	凱文怎麼了
相棒－劇場版－絶体絶命！42.195ｋｍ東京ビッグシティマラソン	相棒劇場版
Lesson Of The Evil	惡之教典
Mongol	鐵木真:開天闢地
Twenty Feet from Stardom	伴唱人生
I'm So Excited	飛常性奮
Absolutely Anything	超能玩很大
Ma ma	為愛而生
The Awakening	靈動檔案
Taichi Hero	太極2:英雄崛起
Close to you	近在咫尺
島田洋七の佐賀のがばいばあちゃん	佐賀的超級阿嬤2
Hitchcock	希區考克
Thor: Ragnarok	雷神索爾3
Lion	漫漫回家路
The Perks of Being a Wallflower	壁花男孩
Shame	性愛成癮的男人
10 Questions for the Dalai Lama	達賴喇嘛十問
While We're Young	青春倒退嚕
Love's Whirlpool	愛的放題
Undertow	暗擁
The Kick	泡菜拳霸
Personal Shopper	私人採購
Seven Something	愛無7限
Tomorrow's Joe	火力拳開
A Thousand Times Good Night	一千次晚安
Measuring the world	丈量世界
Cold Souls	靈魂冷凍庫
One for the Money	頭號冤家
Blade Runner 2	銀翼殺手2
Rust & Bone	烈愛重生
Star Wars: Episode VII	星際大戰7
Pigeon Tango	盜命師
Hippocrate	醫手遮天
Year One in the North	北之零年
Someone Behind You	背後靈
Summer Hours	夏日時光
EVA	EVA奇機世界
A Nail Clippers Romance	指甲刀人魔
The Missing Picture	遺失的映像
パレード	東京同棲生活
Tricks	追火車日記
Guardians	守護者聯盟
Q	巴黎Q孃
Tales From The Golden Age	黃金年代狂想曲
First Time	第一次
The Shack	心靈小屋
Ready Player One	一級玩家
The Imaginarium of Doctor Parnassus	帕納大師的魔幻冒險
Sleepless	限時救援
Sweeney Todd: The Demon Barber of Fleet Street	瘋狂理髮師
The Fatality	絕魂印
The Little Death	愛愛小確性
Dr. Seuss' Horton Hears a Who	荷頓奇遇記
The Way He Looks	愛情的模樣
The White Storm	掃毒
Special Treatment	特別服務
The 15:17 to Paris	15:17巴黎列車
4 Months, 3 Weeks and 2 Days	4月3週又2天
Wolves	狼人鎮
Child's Eye	童眼3D
The Notebook	惡童日記
Populaire	愛在彈指間
Incredibles 2	超人特攻隊2
Another Woman's Face	第2張臉
Paris	巴黎愛情故事
Dan in Real Life	老爸行不行
ドラえもん　のび太のひみつ道具博物館	哆啦A夢2013
Gunman	全面逃殺
God Help the Girl	戀夏小情歌
Smart People	愛情智囊團
Meet the Robinsons	未來小子
Silence	沉默
I Am Love	我愛故我在
Orz Boyz	囧男孩
Atonement	贖罪
Nelly	她的應召日記
A Few Best Man	伴郎我最High
A Golden Boy	謎情三弦
Drifting Flowers	漂浪青春
Emotional Arithmetic	巴黎心楓葉情
Death of a Superhero	愛情超能量
From Prada To Nada	小姐好窮
Wet Woman in the Wind	野風溼身的女人
Paterson	派特森
Glastonbury	搖滾世代
Citizen Dog	大狗民
The Hunger Games: Mockingjay - Part 1	飢餓遊戲3
So Young	致我們終將逝去的青春
A Christmas Tale	屬於我們的聖誕節
The Perfect Girl	最完美的女孩
The Body	屍物招領
An Eye for Beauty	2夜情
Doraemon The Movie 2006	新大雄的恐龍
Stephen King's The Mist	迷霧驚魂
地下鉄（メトロ）に乗って	穿越時空地下鐵
U2 3D	U2:3D立體演唱會
Red Eagle	紅鷹俠
Short Term 12	她和她的小鬼們
The Love of Siam	愛在暹邏
Life Back Then	彼時生命
Before Midnight	愛在午夜希臘時
余命１ヶ月の花嫁	生命最後一個月的花嫁
Mad World	一念無明
The Fox & the Child	狐狸與我
30 Gum Lung Jaew	女人30又怎樣
The Best Offer	寂寞拍賣師
Midsummer Formula	真夏方程式
ヱヴァンゲリヲン新劇場版：序	新世紀福音戰士
Bunny and the Bull	史帝芬的奇幻旅程
Ghost in the Shell	攻殼機動隊
Love Ghost	鬼卜怪談
Wetlands	潮濕地帶
Kokowääh 2	紅酒燉香雞2
Victoria	維多莉亞
what on earth have i done wrong?!	情非得已生存之道
Jumanji: Welcome to the Jungle	野蠻遊戲
Rampart	野獸特警
Detective Conan: Crimson Love Letter	名偵探柯南21
Exeter	鬼附身
Mission: Impossible 5	不可能的任務5
Alvin and the Chipmunks - Chipwrecked	鼠來寶3
Bug	恐怖幻象
The Last Five Years	最後那五年
The Valet	巴黎換換愛
Percy Jackson & The Olympians: The Lightning Thief	波西傑克森:神火之賊
A Royal Affair	皇家風流史
Raging Inferno	天火
Hotel Transylvania 3	尖叫旅社3
Tangerines	橘子收成時
Our Daily Bread	沉默的食物
Coherence	彗星來的那一夜
The Stool Pigeon	線人
Don’t Look Down	精油與肌膚
Ending Note	多桑的待辦事項
The Iron Lady	鐵娘子
劇場版銀魂 完結篇　万事屋よ永遠なれ	銀魂完結篇
A Pigeon Sat on A Branch Reflecting on Existence	鴿子在樹枝上沈思
Zombiology: Enjoy Yourself Tonight	今晚打喪屍
Painted Skin	畫皮
Fast & Furious 7	玩命關頭7
Ida	依達的抉擇
The Sessions	性福療程
Planet B-Boy	街舞開戰
Transporter 3	玩命快遞3
The Blue Bird	青鳥
Starred Up	超危險人物
The Princess and the Frog	公主與青蛙
Dinotasia	荷索之恐龍夢奇地
Me Myself and Mum	媽媽要我愛男人
Tour De Force	生命騎士
Declaration of War	親愛的別哭
Salut d'Amour	愛的禮讚
Hallam Foe	在屋頂上流浪
LOVE	愛
Flash Point	導火線
Laurence Anyways	雙面勞倫斯
Cuban Fury	騷莎大塊呆
Yellow Elephant	黃色大象
Nanimono	何者
End of the Spear	亞馬遜悲歌
Gold	金爆內幕
O.T. phi Overtime	加班遇到鬼
Animals in Love	Kiss小親親
The Teacher's Dairy	教師日記
Adventure of The King	龍鳳店
Grazing the Sky	絕美極限
Moonlight	月光下的藍色男孩
Snatched	搶救千金
Howl	嚎囂
I'm Not There	搖滾啟示錄
The Summer Is Gone	八月
Life Feels Good	人生多美好
Barbara	為愛出走
Sherlock Holmes 2	福爾摩斯2
Black Butterflies	黑蝶漫舞
隠し砦の三悪人	黃金公主
The Attorney	正義辯護人
Small World	繁華夢一場
Parada	彩虹保衛隊
Solitary Man	非關好男人
If You Are the One 2	非誠勿擾2
The Invisible Guest	佈局
The collection	蒐屍魔
Shaolin Girl	少林少女
Je suis Femen	解放女性
Just Between Us	親子與精子
人のセックスを笑うな	不要嘲笑我們的性
Text For You	真愛LINE著你
Letters to Father Jacob	給雅各神父的信
The Vault	惡靈金庫
借りぐらしのアリエッティ	借物少女艾莉緹
Good People	鎖命橫財
Trespass Against Us	犯罪教條
Party Girl	我媽媽是派對女孩
Star Wars: Episode VIII: Space Bear	星際大戰8
Gintama	銀魂
You're Not You	漸動人生
Twilight	暮光之城
The Corpse of Anna Fritz	停屍姦
Stolen	盜數計時
Newness	我們的愛情
沈まぬ太陽	不沉的太陽
I Miss U	屍戀人
Faust	浮士德-魔鬼的誘惑
The Expatriate	關鍵追擊
Marshland	神秘沼澤
X戰警: 未來昔日	X戰警:未來昔日
Flying Colors	墊底辣妹
Women Who Know How to Flirt Are the Luckiest	撒嬌女人最好命
A Chorus of Angels	往復書簡
Bleach	死神劇場版
Last Summer	我死在去年夏天
Victoria and Abdul	女王與知己
Help,I Shrunk My Teacher	我把老師縮小了
Mr. Turner	畫世紀:透納先生
Please, Please Me!	一夜巴黎
Rogue	凶鱷
Hidden Figures	關鍵少數
My Piano	我的小小鋼琴家
Mommy	親愛媽咪
Curse of Lola	詛咒
Beyond the Hills	靈慾告白
The Back-up Plan	備胎女王
The Violin	小提琴革命曲
War for the Planet of the Apes	猩球崛起3
Elegy	禁慾
Learning to Drive	愛情停看聽
Kingsman: The Golden Circle	金牌特務2
Graduation	畢業風暴
Lady Bird	淑女鳥
The Void	恐懼虛空
The Twilight Saga: Breaking Dawn - Part 1	破曉I
White Ant	白蟻:慾望謎網
Let’s Go, JETS!	青春後空翻
Seven Days In Heaven	父後七日
