Mobile Hospital	橫山號
Girls 2	閨蜜2
The Disaster Artist	大災難家
The Florida Project	歡迎光臨奇幻城堡
Wind Blast	西風烈
You Are My Sassy Girl	我是你的野蠻女友
Phobia	鬼4虐
Din Tao: Leader of the Parade	陣頭
Viva Baseball	球來就打
Kung Fu Panda	功夫熊貓
Campus Mystery	筆仙魔咒
Everything Must Go	拍賣人生
The Sweet Smile	雷鋒的微笑
The Time Traveler's Wife	時空旅人之妻
Walk of Shame	姐姐我醉大
Street Kings	正義悍將
Days We Stared at the Sun	他們在畢業的前一天爆炸
Free the Nipple	Lady's 尖頭們
Alibaba 2 solomon seal	阿里巴巴2所羅門封印
Tiger House	顫慄屋
Viking	維京傳說:寒冰交鋒
The Boy	託陰
The 33	33:重生奇蹟
Black Butler - Book of the Atlantic	黑執事劇場版
The New Girlfriend	女朋友的女朋友
Damage	烈火情人
Noah	挪亞方舟
The Big Gay Musical	超級同志音樂會
Zookeeper	全民情獸
How to Train Your Dragon 2	馴龍高手2
Beastly	野獸情人
Relationship Dilemma	分手不分手
Justice League	正義聯盟
Everlasting Moments	靈魂的旅程
Mr. & Mrs. Single	戰國
The Left Ear	左耳
The Deaths of Ian Stone	獵殺死神
Chinese Horrostory	靈臆事件
Son of Stars	星星的孩子
Cosmopolis	夢遊大都會
Daughter	上身
When Love Comes	當愛來的時候
Black Mass	黑勢力
The collection	蒐屍魔
The Complex	黑百合公寓
The Violin	小提琴革命曲
Pieta	聖殤
Xin Zhou	心咒
Kara-Orchestra	很久沒有敬我了妳
See You Tomorrow	擺渡人
Spring Fever	春風沉醉的夜晚
Milk	自由大道
Keeper of Darkness	陀地大法師
Bang! Bang! Formosa	寶島大爆走
Synecdoche, New York	紐約浮世繪
Shadow	獄中驚魂
Nobody Else But You	夢露謎情
Daddy's Home 2	家有兩個爸2
My Awkward Sexual Adventure	我的性愛六堂課
The Sinking City	西謊極落
Pawn Sacrifice	出棋制勝
Fame	名揚四海
Cheers from Heaven	來自天國的喝采
Colic	卡到
TaichiⅡ	太極2英雄崛起
Monkey King: Hero is Back	西遊記之大聖歸來
The Cosplayers	百萬愛情寶貝
Miss Peregrine's Home for Peculiar Children	怪奇孤兒院
Assassin's Creed	刺客教條
Appassionato sonata	熱情奏鳴曲
The Gigolo 2	鴨王2
We Are Young	街舞小子
Outlander	魔獸戰場
借りぐらしのアリエッティ	借物少女艾莉緹
Mr Black&#160;: Green Star	黑貓警長之翡翠之星
Bunshinsaba 2	筆仙Ⅱ
The Silent War	聽風者
Gangster Squad	風雲男人幫
Beyond the Arctic	征服北極
Poltergeist	鬼哭神嚎 惡靈15
Flowers Of Taipei - Taiwan New Cinema	光陰的故事－台灣新電影
We Need to Talk About Kevin	凱文怎麼了
To Sir, With Love	卸屍宴
Naoko	奈緒子
映画ドラえもん　のび太の新魔界大冒険∼７人の魔法使い∼	大雄的新魔界大冒險
Kill Your Darlings	愛殺達令
Dearest	春花秋月不了情
90 Minutes in Heaven	在天堂90分鐘
Inseparable	形影不離
Ballerina	芭蕾奇緣
Ulterior Motive	別有動機
The Bourne Ultimatum	神鬼認證3
Case II	魕異
Why Did I Get Married Too?	結婚真好? 2
Like Life	人生按個讚
Cop Out	波麗士很忙
Zhong Kui: Snow Girl and the Dark Crystal	鍾馗伏魔：雪妖魔靈
Defiance	聖戰家園
A Monster Calls	怪物來敲門
The Receptionist	接線員
Love Speaks	意外的戀愛時光
The Sword Identity	倭寇的蹤跡
Let's Go	保衛戰隊之出動喇！朋友！
Beach Spike	熱浪球愛戰
Blind Spot	探靈檔案
My Brother Is An Only Child	我哥哥是獨生子
Annihilation	滅絕
11 flowers	我十一
Cold Steel	遍地狼煙
Motorway	車手
Ricky	讓愛飛起來
Harry Potter and the Deathly Hallows: Part 1	哈利波特：死神的聖物 I
Winter's Bone	冰封之心
Frost/Nixon	請問總統先生
E-commerce Times	電商時代
The Best Exotic Marigold Hotel	金盞花大酒店
Ice Age: Continental Drift	冰原歷險記4：板塊漂移
Ghost Rider Spirit of Vengeance	惡靈戰警：復仇時刻
Life	我們走過叛逆年代
From Now On	此後
The Debt	惡棍狙擊
Martian Child	我的火星小孩
Microbe & Gasoline	青春冒險王
X-Men: Apocalypse	X戰警:
Dragon Hunter	捉龍特攻隊
Side A Side B	A面B面
Kill The Boss	小魚吃大魚
World War Z	末日之戰
Street Dance 2	3D舞力對決2
The Last Witch Hunter	獵巫行動：大滅絕
We Are Family	我們全家不太熟
One Night in Taipei	台北夜遊團團轉
Burying the Ex	我的屍控女友
The New Orient Shenwa	新東方神娃
One Missed Call	鬼鈴聲
The Wolfman	狼嚎再起
McFarland, USA	夢想越野隊
Legend of A Rabbit: The Martial of Fire	兔俠之青黎傳說
Battle of the Sexes	勝負反手拍
Rainbow Fireflies	彩虹螢火蟲
Bang Bang Formosa	烏龍戲鳳2012
The Hangover Part II	醉後大丈夫2
Mamma Mia!	媽媽咪呀!
Seer Movie 3	賽爾號大電影3戰神聯盟
Joy of Seconf Child	再生之樂
A Single Man	摯愛無盡
Total Recall	攔截記憶碼
Love You You	夏日樂悠悠
Ten Years	十年
The Lobster	單身動物園
Da Huo Zhong	大火種
Doraemon The Movie 2006	新大雄的恐龍
Entrapment	誘狼
High Kickers	捨身技
Up for Love	我的哈比情人
Pleasure Factory	快樂工廠
The To Do List	大學生"做"了沒？
Love on Credit	幸福額度
The Rover	絕命正義
Pride	驕傲大聯盟
Midnight Ghosts	雨夜驚魂
Sex Doll	玩物戀人
Super Three	三小強
Absolutely Anything	超能玩很大
Love is sin	白天的星星
Like Father, Like Son	我的意外爸爸
The Proposal	愛情限時簽
Je suis Femen	解放女性
Man of Tai Chi	太極俠
Lost	迷魂之密室逃脫
The Neon Demon	霓虹惡魔
大決戦！超ウルトラ８兄弟	超鹹蛋超人8兄弟
Lost in Beijing	蘋果
The Ghost Rituals	盂蘭神功
Hellboy II: The Golden Army	地獄怪客2：金甲軍團
Moratorium Tamako	青春,半生不熟
Ghost coins	死人錢
Painted Skin	畫皮
Chaotic Ana	安娜床上之島
The Bird Who Save The World	什麼鳥日子
I Love Hong Kong 2012	2012我愛HK 喜上加囍
Cheri	真愛初體驗
The Big Year	觀鳥大年
Puss in Boots	鞋貓劍客
Legendary Amazons	楊門女將之軍令如山
the tears	傾城之淚
I Don't Know How She Does It	凱特的慾望日記
Hidden Figures	關鍵少數
Twa-tiu-tiann	大稻埕
The Tag-Along	紅衣小女孩
Vincent Wants To Sea	文生去看海
PG Love	PG戀愛指引
ハナミズキ	花水木
The Witnesses	愛滋味
Xi You Xin Zhuan2 ：hen Xin Hua Da Mao Xian	西遊新傳2：真心話大冒險
Seven Days in Heaven	父後七日
Nanking	被遺忘的1937
Winter Sleep	冬日甦醒
New York New York	紐約紐約
Gerald's Game	傑羅德遊戲
War Game 229	燃燒吧！歐吉桑
Rainbow Song	電影情人夢
Break Up 100	不再說分手
She's From Another Planet	人魚校花
The Twilight Saga: Breaking Dawn I	暮光之城：無懼的愛：破曉I
Raging Inferno	天火
Easy Life	喜樂長安
War Room	戰爭房間
Song of the Reed	蘆葦之歌
Astro Boy	原子小金剛
You Are The One	戀者多喜歡
Who is Undercover	一號目標
Seven Psychopaths	瘋狗綁票令
The Pyramid	驚字塔
You Will Be Mine	妳是我的蕾絲邊
Ba Men Jiang Jun	門巴將軍
Cold pupil	冷瞳
God Help the Girl	戀夏小情歌
Carrie	魔女嘉莉
Life As We Know It	命中注定多個你
A Simple Life	桃姐
Laurence Anyways	雙面勞倫斯
The Rite	現代驅魔師
One Hundred Thousand Bad Jokes	十萬個冷笑話
Saving Mr. Wu	解救吾先生
Bruce Lee, My Brother	李小龍
What Women Want	我知女人心
Tiny Times 4.0	小時代：靈魂盡頭
The Martian	絕地救援
Death Note: Light up the NEW world	死亡筆記本:
88 Minutes	死亡倒數88分鐘
The Last Word	她其實沒那麼壞
The Grow 2	金箍棒傳奇2
Long Tou	龍頭
Still Alice	我想念我自己
Faster	限時絕殺
Three Billboards Outside Ebbing, Missouri	意外
Four hands / Mian Yin Zi	面引子 (電影)
Gatchaman	科學小飛俠
Scheme With Me	雙城計中計
The Wonders	蜂蜜之夏
Battlefield Orchid	湘南起義
A Pigeon Sat on A Branch Reflecting on Existence	鴿子在樹枝上沈思
劇場版 黒子のバスケ LAST GAME	影子籃球員
Bitter Harvest	烏克蘭悲歌
The Extreme Fox	非狐外傳
You Are My Sunshine	何以笙簫默
Lost in Vietnam	越囧
Planes: Fire & Rescue	飛機總動員：打火英雄
It	牠
The Guest	神秘訪客
The Angel: The Prescription for Life	天使：生命處方
The Girl Who Played with Fire	玩火的女孩
Tears in Heaven	新媽媽再愛我一次
Yes, Sir!7	報告班長7 無路可退
Lucky Star 2015	吉星高照2015
Ye Mu Jing Hun	夜幕驚魂
The Sleep Curse	失眠
Youth in Revolt	宅男卡卡
Mysterious Face	枕邊有張臉
Tom of Finland	芬蘭湯姆
Hanna	少女殺手的奇幻旅程
The Wind Rises	風起
Shanghai	上海
Selma	逐夢大道
W.	小布希傳
Apollo 18	阿波羅18：不存在的任務
Youthful Days	青春雷鋒
39 Pounds of Love	39磅的愛
Missing	謎屍
I've Loved You So Long	我一直深愛著你
I'm Chinese	我是中國人
The Wave	驚天巨浪
The Cross-generational Dairies	僑女日記
Arthur Christmas	聖誕快遞3D
The Notebook	惡童日記
Yugo&Lala	神秘世界歷險記
Aura star: attack of the temple	奧拉星：進擊聖殿
Diana	黛安娜
Endless Nights In Aurora	極光之愛
Double Xposure	二次曝光
Diary of a Wimpy Kid	遜咖冒險王
Hoodwinked Too! Hood vs. Evil	小紅帽2
Taste of China	味道中國
21	決勝21點
Curse of Lola	詛咒
Room in Rome	羅馬慾樂園
Snowden	神鬼駭客:史諾登
Takers	偷天搶地
Mr.GO	王牌巨猩
A Style of a man in beijing	北漂魚
What If	好友戀習簿
A Nightmare on Elm Street	半夜鬼上床：夢殺
Lemon Tree	檸檬樹
Monga	艋舺
2 Guns	2槍斃命
New Happy Dad and Son 2: The Instant Genius	新大頭兒子小頭爸爸2一日成才
Bangkok Traffic (Love) Story	下一站說愛你
Oba: The Last Samurai	太平洋的奇蹟
I Origins	I型起源
Middle Men	中間人
My Little Honey Moon	內人／外人－野蓮香
SeerⅡ	賽爾號2：雷伊與邁爾斯
Night of a 1000 Hours	風水逝家
The Perfect Guy	完美傢伙
The Butcher, the Chef, and the Swordsman	刀見笑
Bodyguards And Assassins	十月圍城
Feng Kuang De Chun Zei	瘋狂的蠢賊
Cooties	殭屍小屁孩
Brave Story	勇者物語
Dad, I Will Rescue You	爸爸我來救你了
Who in the mirror	半夜不要照鏡子
The Third Wish	第三個願望
Waz	要命法則
The Boss Baby	寶貝老闆
The White Haired Witch of Lunar Kingdom	白髮魔女傳之明月天國
Love Simply	簡單愛
Walking With Dinosaurs 3D	與恐龍冒險3D
Soul House	怨靈地下室
Sleepless	限時救援
Bachelors' love	光的棍
What Just Happened?	顛覆瘋雲
The Foreigner	英倫對決
Juno	鴻孕當頭
Bad Guys Always Die	壞蛋必須死
Kidnap Ding Ding Don	綁架丁丁當
Quantum of Solace	007量子危機
The Adventures of Tintin: Secret of the Unicorn	丁丁歷險記
The Ghouls	尋龍訣
The Bye Bye Man	冤親債主
Adventure at Flaming Moutains	火焰山歷險記
Rhapsody of Marriage	結婚狂想曲
One for the Money	頭號冤家
Out of Ordinary	非同小可
Eagle Eye	鷹眼
Wansei Back Home	灣生回家
The Queen of Spain	天后開麥拉
MayDay Nowhere3D	5月天諾亞方舟
Sunshine on Leith	愛在陽光燦爛時
Hello Babies	六福喜事
Mortician	臨終囧事
Perfect Mothers	愛墮落
Breakup Buddie	心花路放
Turning Point 2	Laughing Gor之潛罪犯
The Bullet Vanishes	消失的子彈
Evil Dead	屍變
After Earth	地球過後
Despicable Me 2	神偷奶爸2
Haunts	亡魂出沒
Mr. Six	老炮兒
Sisterhood	骨妹
Happy together-all about my dog	狗狗當家
The Railway Man	心靈勇者
Lei Feng Man	熱血雷鋒俠之激情營救
RailWay	鐵支路
Julieta	沉默茱麗葉
The Private Lives of Pippa Lee	她的私密日記
A Perfect Getaway	蜜月變奏曲
Young Detective Dee: Rise of the Sea Dragon	狄仁傑之神都龍王
Young Blood	青春搏擊
Goya's Ghosts	哥雅畫作下的女孩
Friend Request	非死不可
O.T. phi Overtime	加班遇到鬼
Little Fockers	門當父不對之我才是老大
Case Sensitive	敏感事件
A Motor Home Adventure	房車奇遇
Hot Pursuit	辣味雙拼
ノルウェイの森	挪威的森林
Black & White Episode 1: The Dawn of Assault	痞子英雄首部曲
Family Rules	家有家規
Flash Play	致命閃玩
The Air I Breathe	交錯效應
Operation Mekong	湄公河行動
East Wind Rain	東風雨
In a Better World	更好的世界
The Mortal Instruments: City of Bones	天使聖物：骸骨之城
The Edge of Heaven	天堂邊緣
Up In The Wind	等風來
Public Friends	玩命光頭
Xiang Xiao Qiang Yi Yang Huo Zhe	像小強一樣活著
Robin Hood	羅賓漢
Harry Potter and the Deathly Hallows Part 2	哈利波特—死神的聖物II
Sara	雛妓
Chinese Look	正骨
Revenge, A Love Story	復仇者之死
Romance Out Of The Blue	浪漫天降
Eternal Love	201413愛你一世一生
The Adjustment Bureau	命運規劃局
Percy Jackson: Sea of Monsters	波西傑克森：妖魔之海
Taichi 0	太極
The Captive	雪地迷蹤
Please Open Your Window	請把你的窗戶打開
SuckSeed	音為愛
Talaash	大搜索
Fierce midnight dream	午夜凶夢
Madea's Witness Protection	黑瘋婆的證人保護計劃
The Next Three Days	關鍵救援72小時
Kingfisher	魚狗
Home	好家在一起
The Incredible Hulk	無敵浩克
Broken City	驚爆危城
Terminator: Genesis	魔鬼終結者5
劇場版 FAIRY TAIL -DRAGON CRY	魔導少年:龍之淚
Honey PuPu	消失打看
Parada	彩虹保衛隊
Happy Few	你快樂所以我快樂
Book Of Love	北京遇上西雅圖之不二情書
Clara	琴戀克拉拉
The Descent: Part 2	深入絕地2
She Zhou	蛇咒
The Sun Also Rises	太陽照常升起
The Doll	詭娃娃
Unexpected Love	誰說我們不會愛
あたしンち　情熱のちょ∼超能力♪母 大暴走	超能力花媽
Guardians of the Galaxy	星際異攻隊
When a Peking Family Meets Aupair	洋妞到我家
Captain Fantastic	神奇大隊長
Ice kacang puppy love	初戀紅豆冰
The White Ribbon	白色緞帶
Ming Tian Shi Fou Lai Lin	明天是否來臨
Perfect Wedding	抱抱俏佳人
Legend of the Guardians	貓頭鷹守護神
Tik Tok	驚天大逆轉
Heart for Heaven	一念天堂
Lan	我們天上見
Bang Jia Da Ming Xing	綁架大明星
Legend of the Guardians: The Owls of Ga'Hoole	貓頭鷹守護神
Couples Retreat	伴侶渡假村
Scream 4	驚聲尖叫4
Lian Huan Kou	連環扣
The Man From Macau	澳門風雲
The Butler	白宮第一管家
The Day the Earth Stood Still	當地球停止轉動
Cloudy With a Chance of Meatballs 2	食破天驚2
Unstoppable	煞不住
Walking on Sunshine	舞力假期
A Beautiful Star	美麗之星
I Hate Valentine's Day	我恨情人節
Largo Winch	神鬼獵殺
Phoenix	回不去的時光
Captain America: The Winter Soldier	美國隊長2：酷寒戰士
Mother's Day	母親劫
Kwai Boo	桂寶大電影之爆笑闖宇宙
December Boys	十二月的男孩
Naked Human Nature	赤裸人性
The Game	致命怪談
Old Dogs	歐吉桑卡好
Runner Runner	逆轉王牌
Just Go With It	愛情大臨演
Good Luck! Boy	加油！男孩
Gnomeo & Juliet	糯米歐與茱麗葉
The Family Running Forward	一家老小向前沖
Brothers	鋼刀
Last Testimony	最後證言
The Incredible Truth	瘟泉
Roommates in Love	異性合租的往事
Mr. Right	真愛有夠殺
You Again	冤家囍相逢
Chinese Puzzle	紐約愛情拼圖
Merry-Go-Round	東風破
The Cabin in the Woods	詭屋
Horrible Bosses	老闆不是人
The Internship	實習大叔
Baggage Claim	行李帶
Moms' Night Out	老媽之夜
Crouching Tiger, Hidden Dragon: Sword of Destiny	臥虎藏龍：青冥寶劍
Love in the 1980s	1980年代的愛情
Survivor	倒數行動
The Magic of Children&#160;: Magic Attack	小魔仙之黑魔法來襲
Sin City: A Dame to Kill For	萬惡城市：紅顏奪命
Juliets	茱麗葉
American Reunion	美國派4：美國重逢
Kepong Gangster	甲洞
Magic Barber	愛情魔發師
Lost Minds	失心者
Perfect Two	新天生一對
Mortal Engines	移動城市:致命引擎
The Second Woman	情謎
Iceman	急凍行者（上卷）
The Last Face	戰地情
Heaven Is for Real	真的有天堂
Never Said Goodbye	謊言西西里
The Death War	絕戰
City of Ember	微光城市－黑暗之光首部曲
Love You For Loving Me	我愛的是你愛我
Ocean Flame	一半海水,一半火焰
Three Weddings	爸爸的3次婚禮
The Lost City of Z	失落之城
Hansel And Gretel: Witch Hunters	女巫獵人
Cities In Love	戀愛中的城市
Nymphomaniac	性愛成癮的女人
The moment you fall in love	喜歡上你的那瞬間
One Tree Three Lives	三生三世聶華苓
Father(Abba)	阿爸 (電影)
Stratton	金牌特勤
Black Rock	黑色搖滾
Dracula Untold	德古拉:永咒傳奇
Cool Ma	酷馬
Inside Out	腦筋急轉彎
Non-Stop	空中救援
UMRIKA	歡迎來到美國
Just Call Me Nobody	大笑江湖
House of Lies	謊言對決
One Night	練膽兒
Lokah Laqi！	只要我長大
Insidious Chapter 2	陰兒房2
Gulf Stream Under the Iceberg	性愛慾3世紀
Golden Brothers	男人唔可以窮
Plastic Surgeon·Hunted Face	整形師·臉
Le Week-End	愛在巴黎破曉時
The Warrior and the Wolf	狼災記
Two Idiots	傻瓜向錢衝
Brain on Fire	我發瘋的那段日子
The Menu	導火新聞線
Tower Heist	神偷軍團
Goosebumps	怪物遊戲
Alaska	愛,囚禁
You Deserve To Be Single	活該你單身
21 Jump Street 2	龍虎少年隊2
Saw V	奪魂鋸5
Jin Tian Ming Tian	今天·明天
North by Northeast	東北偏北
The Awakening	靈動檔案
Mountain Ava	森林孤影
Four	鬼4厲
If I Were You	變身男女
Minions	小小兵
Joy	翻轉幸福
You Won’t Get to Live Twice	三個大丈夫
The mask of love	魅妝
One Nation, Two Cities	一國雙城
Love &amp; Mercy	搖滾愛重生
Blackhat	黑帽駭客
NARA：奈良美智との旅の記録	跟著奈良美智去旅行
Julie & Julia	美味關係
Blue Valentine	藍色情人節
The Story of A Piano	琴動我心
One Minute More	我的男友和狗
Dorian Gray	美少年格雷的畫像
When the Game Stands Tall	攻無不克
The Walk	走鋼索的人
Fighting Youth	我是奮青
I Love Wing Chun	笑詠春
A Chinese Ghost Story	倩女幽魂
Strangrland	陌生之地
Cha Cha for Twins	寶米恰恰
Outsourced	世界是平的
火垂るの墓	螢火蟲之墓
The House Bunny	女郎我最兔
Muppets Most Wanted	布偶歷險記：全面追緝
People Like Us	平凡人生
The Maze Runner	移動迷宮
The Happy Life of Debbie	內人／外人－黛比的幸福生活
Two Days, One Night	兩天一夜
Baby Run	寶貝快跑
Spy Time	特務超級爸
Black Panther	黑豹
The Experiment	叛獄風雲
Free Ride	順風車
Bee Movie	蜂電影
Detectivecconan：Sunflowes Of Inferno	名偵探柯南19
Ju-on: The Beginning of the End	咒怨:終結的開始
The Truth About Beauty	整容日記
Skyfall	007：空降危機
The Brand New Testament	死期大公開
Alien: Covenant	異形:聖約
Epitaph	冥婚淒談
Marvel Stories	漫威:超級英雄王國
分手說愛你	分手說愛你
Yes Man	沒問題先生
China Heavyweight	千錘百鍊
Strange Magic	仲夏夜魔法
West Groovy	哥的傳說
Now You See Me	出神入化
Season of Good Rain	好雨時節
The Invincible Piglet	無敵小飛豬
When Yesterday Comes	昨日的記憶
Just For Fun	就是鬧著玩的
Rock'n Roll	搖滾救明星
Gu Gu the Cat	咕咕貓
Monkey Kingdom	猴王國
Dendrobium	石斛蘭
Late Autumn	晚秋
The Weird Bride	詭新娘
The love Clinic	愛情維修站
Escape Plan	鋼鐵墳墓
Tomorrow's Joe	火力拳開
Madea's Big Happy Family	黑瘋婆子的快樂大家庭
Children From The Distant Planet	遙遠星球的孩子
Connected	保持通話
The Warring States	戰國
The Big Power	大顯神威
余命１ヶ月の花嫁	生命最後一個月的花嫁
From a House on Willow Street	綁的不是人
Natural Born Lover	這個男人有點色
The Disappointments Room	鬼開門
Paranormal Activity 2	鬼入鏡
KungFu Fighter	功夫戰鬥機
The Warth Of Vajra	金剛王：死亡救贖
Pacific Rim: Uprising	環太平洋2
This Is the End	大明星世界末日
Yang Xiong Yu Shi Xiu	楊雄與石秀
The KungFu Master	八卦宗師
Silk Road Hero: Khan's Arrow	絲路英雄·雲鏑
Atonement	贖罪
Saving Mr. Banks	大夢想家
We Bought a Zoo	我們買了動物園
Miles Ahead	瘋狂邁爾士
Da Cun Gu	大村姑
Kokowääh 2	紅酒燉香雞2
Love in the Office	一路向前
Margin Call	黑心交易員的告白
The Lazarus Effect	永夜魔女
Bachelorette	伴娘Hold不住
Yves Saint Laurent	時尚大師聖羅蘭
Attraction	異星引力
The Mirror	魔鏡
BiXian Panic	筆仙驚魂
The Sense of an Ending	回憶的餘燼
Solomon Kane	所羅門傳奇
Hero of the River	劍河
Dynamite Warrior	功夫拳霸
Doomsday	決戰末世代
Last Summer	我死在去年夏天
Summer Rain	夏季雨
Crazy on the Outside	出獄一團糟
The Triangle Land	三角地
Zinnia Flower	百日告別
Overdrive	盜速飛車
Obvious Child	只是個孩子
Rock the Kasbah	沙漠飆高音
The Strangers	陌路狂殺
Forever Young	怒放之青春再見
Da Han Tao Hua Kai	大寒桃花開
My New Sassy Girl	我的新野蠻女友
Take me home	鬼打牆
The Twilight Saga: Breaking Dawn - Part 1	破曉I
Paranormal Activity: Tokyo Night	靈動2:東京實錄
Lan Kwai Fong II	喜愛夜蒲2
Taste of Life	百味人生
The Trump Card	誰是臥底之王牌
Inside Job	幕後黑手
The Monuments Men	大尋寶家
Gone with the Bullets	一步之遙
Snow White and the Huntsman	公主與狩獵者
My back page	革命青春
The Orphanage	靈異孤兒院
Mystery	浮城謎事
Night Train to Lisbon	里斯本夜車
Louder Than Bombs	記憶乍響
Ice Age: Dawn of the Dinosaurs	冰原歷險記3
The Survival Family	生存家族
Out in the Dark	愛,悄悄越界
Mr. Donkey	驢得水
Good People	鎖命橫財
Flirting Scholar 2	唐伯虎點秋香2之四大才子
3AM	鬼三驚
A Horse with Hope	山那邊有匹馬
The Kidnap	綁架冰激凌
The Words	千言萬語
The Last Woman Standing	剩者為王
Final Destination 5	絕命終結站5
Seven Arhat	七小羅漢
Paranormal Activity: The Ghost Dimension	鬼入鏡5
Wind River	極地追擊
American Assassin	美國刺客
A Pierrot	重力小丑
The Little Death	愛愛小確性
The Adventurers	俠盜聯盟
The Immigrant	浮世傷痕
Rock On	實習大明星
My Friends	我的「狐朋狗友」
Letters to Father Jacob	給雅各神父的信
Beloved Sisters	二姊妹的情人
When We Were Young	不朽的時光
Xiao Che	校車 (電影)
The Conspirator	刺客共犯
I Love HongKong	我愛HK開心萬歲
The Thieves	神偷大劫案
Zero Days	零日網路戰
Guo Ming Yi	郭明義
Chimpanzee	黑猩猩
Sex, Party and Lies	謊言性派對
The World in Two Round Trips	小人物征服大世界
Unforgettable Golden Beach	難忘金銀灘
Beyond Skyline	天劫:救贖之戰
Na Na De Mei Gui Zhan Zheng	娜娜的玫瑰戰爭
Jackass Presents:Bad Grandpa	無厘取鬧:祖孫卡好
Planetarium	通靈美人
Sadako 3D	貞子3D
Sick Nurses	恐怖護理站
The Little Mermaid: Attack of The Pirates	美人魚之海盜來襲
The Ghost Tales	變羊記
The Best of Me	有你，生命最完整
Gone	致命救援
Double Trouble	寶島雙雄
12 Citizens	十二公民
The Ghost Festival	盂蘭神功
The Human Centipede 3	人形蜈蚣3
Bad Girls	女孩壞壞
The Next Magic	下一個奇蹟
Shi Laihe Son of Earth	大地赤子史來賀
Mr. & Mrs. Gambler	爛賭夫鬥爛賭妻
99 Homes	居住正義
American Sniper	美國狙擊手
One Direction: This Is Us	1世代：我們的世代
Gunman	全面逃殺
Kung Fu Angels	精武青春
Ghost of Model	模特魅影
Tekkonkinkreet	惡童當街
Revanche	維也納復仇
I Kissed a Girl	新郎嫁錯郎
Annabelle	安娜貝爾
The Crossing Ⅱ	太平輪：驚濤摯愛
Gintama	銀魂
The Possession of Emma Evans	惡靈附體
Love at First Sight	第一眼愛情
The Last Five Years	最後那五年
Yong Chun Xiao Long	詠春小龍
Killer Elite	殺手精英
Midnight Sun	極地奇蹟
Allacciate Le Cinture	愛情初邂逅
labor day	一日一生
Ghost House	猛鬼抓交替
Oslo, 31. august	八月三十一日,我在奧斯陸
Go Lala Go 2	杜拉拉追婚記
Love, At First	愛之初體驗
Young Time	青春時光
The Fluffy Movie	蓬鬆哥脫口秀
20th Century Boys 3: Our Flag	20世紀少年3
Ninja Assassin	忍者刺客
Who Gets the Dog?	毛小孩選邊站
My Best Friend's Girl	壞壞惹人愛
Alone	連體陰
I Am Not A Thief	我不是賊
Desperate Rescue	危情營救
Take the A Train	幸福特快車
Rookie Chef	神廚
Perfect Strangers	完美陌生人
パレード	東京同棲生活
Enter the Void	嗑到荼蘼
Rhythm of the Rain	聽見下雨的聲音
Comet Impact	2008隕石噩夢
The Book Thief	偷書賊
Rock Hero	搖滾英雄
Rock Me To The Moon	一首搖滾上月球
Office	華麗上班族
The Wait	西西里的漫長等待
The Somalia Truth	索馬利亞真相
Return of the Cuckoo	十月初五的月光
My Rainy Days	天使之戀
Pleasant Goat and Big Big Wolf 6	喜羊羊與灰太狼6之飛馬奇遇記
The Kid From The Big Apple	我來自紐約
A Fool	一個勺子
A Tale of Three Cities	三城記
Love's Whirlpool	愛的放題
Transformers 4	變形金剛4
Savages	野蠻告白
Ong bak 2	拳霸3
Mad Max: Fury Road	瘋狂麥斯：憤怒道
Goemon	大盜五右衛門
Woman in Gold	名畫的控訴
Hit & Run	飆客找麻煩
The 33D Invader	蜜桃成熟時33D
Detroit	底特律
Huang Haihuai	黃海懷
The Spring Of My Life	最美的時候遇見你
True Story	真實的故事
Hermano	你是我兄弟
Dr. Seuss' Horton Hears a Who	荷頓奇遇記
One Night of Fate	一夜危機
Okja	玉子
I Love wolffy 2	我愛灰太狼2
The Search for General Tso	尋找左宗棠
Fly Me to the Moon	真愛找冤家
Burlesque	舞孃俱樂部
The Crossing Part 2	太平輪:驚濤摯愛
Under The Bed 3	床下有人3
12 Strong	12猛漢
One Piece Film Gold	航海王電影 Gold
Zombiology: Enjoy Yourself Tonight	今晚打喪屍
The Butcher, the Chef and the Swordsman	刀見笑
Blind Detective	盲探
Hector and the Search for Happiness	尋找快樂的15種方法
Step Up 3D	舞力全開3D
Estômago	刑男大主廚
Kung-Fu Yoga	功夫瑜伽
Black Coal, Thin Ice	白日焰火
Jan Dara: The finale	晚孃下部:罪色
Then She Found Me	再給愛一次機會
Closing the Ring	戒情人
From Vegas to Macau III	賭城風雲III
The Conjuring	厲陰宅
Ondine	情陷美人魚
Long's Story	硬漢奶爸
Hill of Ilha Verde	青洲山上
Bad Sister	壞姐姐之拆婚聯盟
Ida	依達的抉擇
Jurassic Park 3D	侏羅紀公園3D
No Zuo No Die	我就是我
The Ghost Tale	變羊記
Zero Point Five Love	0.5的愛情
I Love You Phillip Morris	娘子漢大丈夫
The Chef, The Actor, The Scoundrel	廚子戲子痞子
Billy Lynn’s Long Halftime walk	比利林恩的中場戰事
The Sword of Love	潘多拉的寶劍
Muoi : The Legend of a Portrait	替屍鬼
Mission: Impossible Ghost Protocol	不可能的任務4：鬼影行動
Lucky Dog	石器時代之百萬大偵探
Somewhere	迷失某地
Life as We Know It	命中注定多個你
Mao Zedong and Qi Baishi	毛澤東與齊白石
X+Y	愛的方程式
Isle of Dogs	犬之島
Fight For Justice	進擊之路
Pricess Show	公主的誘惑
The Host	宿主
A Walk Among the Tombstones	鐵血神探
Dawn of the Felines	母貓
The Swimmers	水男骸
Source Code	啟動原始碼
Ice Kacang Puppy Love	初戀紅豆冰
Be A Mother	母語
The Secret Life of Pets	寵物當家
Spiny Life	刺蝟小子之天生我刺
Jackass 3D	無厘取鬧3D
Truth or Brave	真心話大冒險
Life on the Line	命懸生死線
映画ドラえもん　のび太と緑の巨人伝	大雄與綠巨人傳
Jurassic World	侏羅紀世界
A Little Bit of Heaven	想愛趁現在
30 Days of Night	貝武夫:夜三十
Out of Control	失控
Heroes Wanted	魯蛇特攻隊
Vengeance	邪靈復仇
52 Tuesdays	52個星期二
Eden Lake	獵人遊戲
Riding The Breeze	南風
Moonlight Love	月光戀
The Boxtrolls	怪怪箱
Hachiko: A Dog's Story	忠犬小八
Smart People	愛情智囊團
MIB 3	MIB星際戰警3
Captain Abu Raed	愛無盡夢飛翔
South of the Clouds	北回歸線
The Fortune Buddies	勁抽福祿壽
The Collector	蒐屍魔前傳
Wrath of the Titans	怒戰天神
The Frightening Night	夜驚魂
Fight it&#160;! Youth	奮鬥吧！青春
A Chinese Odyssey: Part Three	大話西遊3
Maleficent	黑魔女：沉睡魔咒
Toxic Poisoning	毒中毒
A Dog Named Wang Zi	一條叫王子的狗
The Angriest Man in Brooklyn	布魯克林最憤怒的人
Feed Me	哺乳期的女人
Of Gods and Men	人神之間
Les Aventures D'Anthony	陪安東尼度過漫長歲月
Dancing in the Room	房間裡的舞蹈
Last Day of Summer	夏日之末
The Five-Year Engagement	五年之約
ブタがいた教室	和豬豬一起上課
Love In Time	等我愛你
Zoolander 2	名模大間諜2
10000 Years Later	一萬年以後
Magnifica Presenza	亮演人生
Day of Redemption	早見，晚愛
Shinjuku Incident	新宿事件
Spotlight	驚爆焦點
The Writing's On The Wall	有跡可循
Pride and Glory	非法警戒
Love Contractually	合約男女
Sons of Norway	搖擺天體營
Reign of Assassins	劍雨
Short Term 12	她和她的小鬼們
The King of Tibetan Antelope	藏羚王之雪域精靈
Anomalisa	安諾瑪麗莎
Cha-Cha for Twins	寶米恰恰
Cold Bloom	愛在櫻花紛飛時
Lacuna	醉後一夜
Memory Loss	憶世界大冒險
Deeper	性愛巴弒
Paul	我們撞到外星人
Black Ransom	撕票風雲
Guilty of Romance	戀之罪
4 Months, 3 Weeks and 2 Days	4月3週又2天
Sorority Row	女生殺人宿舍
Child's Eye 3D, The	童眼3D
The Search For General Tso	尋找左宗棠
Lan Kwai Fong 3	喜愛夜蒲3
The Midnight After	那夜凌晨，我坐上了旺角開往大埔的紅van
Extremely Urgent	迫在眉睫
The Paradise Suite	夢碎天堂
Crazy New Year's Eve	一路驚喜
Morning Glory	麻辣女強人
Once a Gangster	飛砂風中轉
Taste Of Spring	大劫難
The Evil in Us	命屍樂園
The Campaign	官賤對決
A Silent Voice	電影版聲之形
Baseballboys	野球孩子
Fatal Invitation	致命請柬
Again	青春殘愛物語
Piranha 3D	3D食人魚
First of May	十七歲
Chongqing Hot Pot	火鍋英雄
Furious 7	玩命關頭7
Happy Little Submarine 3: Rainbow Treasure	潛艇總動員3--彩虹寶藏
Sorry If I Love You	熟男我愛你
Shining Soul	閃魂
Photo Album of the Village	村之寫真集
崖の上のポニョ	崖上的波妞
The Family	黑幫追殺令
Dream Home	維多利亞壹號
Decrepit Dream	殘夢
Devil‘s right hand	制服
Pay Back	獵仇者
Show me your love	大手牽小手
Marshland	神秘沼澤
Murder At Honeymoon Hotel	蜜月酒店殺人事件
My Soul to Take	生日劊樂
GATAO	角頭
No Man Land	無人區
Close to the Sun	雲上太陽
Dark Places	暗處
Saint Amour	醉後之旅
Man on a Ledge	驚天換日
Semi-Pro	灌籃大帝
[REC] 4: Apocalipsis	錄到鬼4
The Buried Secrets	紅髏
Disney's A Christmas Carol	聖誕夜怪譚
Live Free or Die Hard	終極警探4
Truth	真相急先鋒
Honey Enemy	情敵蜜月
Dangal	我和我的冠軍女兒
Murderer	殺人犯
A Cherry on a Pomegranate Tree	石榴樹上結櫻桃
In Time	鐘點戰
Dead Man Down	無間殺手
Hearty Paws	伴我走天涯
The Nightingale	夜鶯
From Up On Poppy Hill	來自紅花坂
Her	雲端情人
Rurouni Kenshin	神劍闖江湖
Bateelaer saga	巴特拉爾傳說
The Canal	運河怪談
League Of Gods	封神傳奇
Step Back to Glory	志氣
Fantastic Four	驚奇4超人
The Lead Singer and Dancer and His Woman	傘頭和他的女人
Dumb and Dumber To	阿呆與阿瓜：賤招拆招
Midnight at University	鬼才要畢業
KANO	KANO
Armor Hero Captor King	鎧甲勇士捕王
Headhunters	獵頭遊戲
Fruit Rockers	搖滾水果
Time is Money	十萬夥急
Xiong Chu Mo	熊出沒之奪寶熊兵
Roommate	我的恐怖室友
Why Him?	惱爸偏頭痛
George A. Romero Survival of the Dead	活死人之島
Virgin Snow	初雪之戀
Very Kidnappers	非常綁匪
The Cases	魕
Love on the Cloud	微愛之漸入佳境
Sex, Love & Therapy	性愛診療室
In the Name of the King: A Dungeon Siege Tale	末日危城
Wedding Daze	先婚後友
Stronger	你是我的勇氣
Alvin and the Chipmunks	鼠來寶
Mae Bia	蛇姬:極樂誘惑
Easy A	破處女王
Johnny English Reborn	凸搥特派員：二度出包
Animals in Love	Kiss小親親
the True Love	不愛不散
Beijing Love Story	北京愛情故事
Daybreakers	血世紀
Indomitable Soldiers	殘團
Beasts of the Southern Wild	南方野獸樂園
Love On Gallerv Bridge	愛在廊橋
Hotel Transylvania 2	尖叫旅社2
Life of Crime	百萬嬌妻綁架計畫
The Art of Mr.Chow	少年班
Pitch Perfect	歌喉讚
Yin Qing Yuan Que	因情圓缺
Port of Call	踏血尋梅
Mama	母侵
Passengers	靈異航班
Golden Chicken S	金雞SSS
You're Not You	漸動人生
Perfect Stranger	勾引陌生人
The Legend of Hercules	鋼鐵力士
50/50	活個痛快
Secret	不能說的秘密
African Cats	非洲大貓
Happy Dorm	極樂宿舍
The Last Supper	王的盛宴
Lost in Hong Kong	港囧
There They Were	此間的少年
S for sex S for secret	小姐誘心
Hijack	被劫持的愛情
Equals	禁愛世界
Beauty on Duty	美麗密令
Wonderful World	美好世界
Cupid Arrow	愛神箭
Angel's Egg	天使之卵
Love is not Blind	失戀33天
Ip Man	葉問
Timbuktu	在地圖結束的地方
The Four 3	四大名捕大結局
Mirror Mirror	魔鏡，魔鏡
Bridget Jone's Baby	BJ有喜
Unbeatable	激戰：勇者不敗
The Soul of Bread	愛的麵包魂
Lovely Devil	痞子·洛克
The Tree of Life	生命樹
Nessun Dorma	兇手還未睡
God’s Hug	男神抱抱
The Reader	為愛朗讀
Doctor Strange	奇異博士
A Rolling Stone	築巢人
Kara King	冠軍歌王
Meet the Robinsons	未來小子
Queen of the Mountains	庫爾曼江·達特卡
The Unbelievable 2: Channeling the Spirits	怪談電影 - 撩鬼
Black Comedy	黑色喜劇
96 Hours	生死96小時
Ted	熊麻吉
Railroad Tigers	鐵道飛虎
The Green Hornet	青蜂俠
Ip Man 2	葉問2
Divergent	分歧者
Dance Subaru	芭蕾少女
I Want You	中國好聲音之為你轉身
Rings	七夜怪譚
Bugs	食人蟲
Ocean Butterfly	蝴蝶魚
Cave of Forgotten Dreams	3D祕境夢遊
Buried	活埋
Outcast	白幽靈傳奇之絕命逃亡
The Way We Were	算把啦，老豆！
Speed Master	極速狂飆
Happiness	幸運是我
Wonder Wheel	愛情摩天輪
Sex duties unit	飛虎出征
The Great Hypnotist	催眠大師
Midnight Microblog	午夜微博
未來預想圖	未來預想圖
Ma ma	為愛而生
The Beaver	海狸先生
As The Light Goes Out	無路可退
Grey Met Shrek	奇緣灰姑娘
The Commune	丹麥共居生活
Populaire	愛在彈指間
Legend of the Fist: The Return of Chen Zhen	精武風雲·陳真
Nina Forever	非普通屍戀
Leviathan	纏繞之蛇
My Wife is a Superstar	我老婆是明星
David Loman 2	大尾鱸鰻2
Don't talk about High-Rich and Handsome	別跟我談高富帥
Monsters	異獸禁區
The Fencer	擊劍大師
Ballistic	彈道
2 Days in Paris	巴黎二日情
Gifted	天才的禮物
Cycling Angels	單車天使
R.I.P.D.	降魔戰警
Alexander and the Terrible, Horrible, No Good, Very Bad Day	亞歷山大衰到家
Meeting the Giant	再見巨人
Midsummer Formula	真夏方程式
Close to You	近在咫尺
Cloud Atlas	雲圖：穿越過去未來
Rigor Mortis	殭屍
Drgaon Blade	天將雄師
Hotel Deluxe	百星酒店
Before Memories After Oblivion	回憶之前，忘記之後
Nobody’s Perfect	沒問題三班
Town of the Dragon	臥龍崗
Dolphin Tale 2	溫特的故事：泳不放棄2
Girl in Progress	女孩向前衝
Dot 2 Dot	點對點
To My Wife	百年情書
Small World	繁華夢一場
Orange Love	愛情公寓
Ilo Ilo	爸媽不在家
Twentieth Century Boys	二十世紀少年
Looking For The Holy Land	我的聖途
Starlit High Noon	日正當中的星空
Godzilla	哥吉拉
Back on Track	最後的馬拉松
The Deadly Reasoning	奪命推理
The Flying Machine 3D	夢幻飛琴
The Numbers Station	數字戰
The Book of Life	曼羅奇遇記
Alien Abduction	詭影訪客
The Sorcerer's Apprentice	魔法師的學徒
The Con Artists	技術者們
What Makes Love Last	長情的告白
The Man Who Knew Infinity	天才無限家
The Little Prince	小王子
Kingsman: The Golden Circle	金牌特務2
Snowfall in Taipei	臺北飄雪
My Blind Uncle	阿輝的女兒
Gui Da Qiang	詭打牆
Sicario	怒火邊界
Patriots Day	愛國者行動
Shutter Island	隔離島
Sky on Fire	沖天火
Mountains May Depart)	山河故人
120 Beats Per Minute	120拍的節奏
My King	我心深愛的國王
The Devil Inside Me	奪命心跳
Charlie St. Cloud	生死情緣
Sex & Chopsticks	金瓶梅
Follow Me,My Queen	女神跟我走
Teenage Mutant Ninja Turtles 2	忍者龜2:破影而出
Haunting Love	詭愛
R.I.P.D	降魔戰警
It's a Wonderful Afterlife	美好來生
If You Are The One 2	非誠勿擾2
Love In Space	全球熱戀
Big Mommas: Like Father, Like Son	絕地奶霸：唬父無犬子
Our Brand Is Crisis	危機女王
The Moonlight in Jilin	內人／外人－吉林的月光
The intruder	蛇降
Son of God	上帝之子
Ex	前度
島田洋七の佐賀のがばいばあちゃん	佐賀的超級阿嬤2
Where Got Ghost	嚇到笑
When Miracle Meets Maths	愛情算不算
Big Miracle	鯨奇之旅
Rabbit Without Ears	沒有耳朵的兔子
The Adventures of Jinbao	大兵金寶曆險記
Redline	超時空甩尾
Online	時光大戰
X-Files: I Want to Believe	X檔案：我要相信
Horton Hears a Who!	荷頓奇遇記
Flatliners	別闖陰陽界
Love & Mercy	搖滾愛重生
Choileefat	蔡李佛拳
Mad World	一念無明
All’s Well, Ends Well 2012	八星抱喜
Revenge of Gold	流金
Please, Please Me!	一夜巴黎
踊る大捜査線　THE MOVIE３	大搜查線3
What's in the Darkness	黑處有什麼
The Road	窮途
Fleet of Time	匆匆那年
It's Only the End of the World	不過就是世界
Come for You	為你而來
Naked Soldier	絕色武器
The Salt of the Earth	薩爾加多的凝視
The Gambler	玩命賭徒
The making of a man	男人製造
A Werewolf Boy	狼少年
Summer Palace	頤和園
People Searching Story of Cola Lee	李可樂尋人記
Glastonbury	搖滾世代
Saw 3D	奪魂鋸3D
Chasing is Hurting	不要迷戀姐
The Four 2	四大名捕II
A Most Violent Year	暴力年代
My Circle of Friends	我的朋友圈
Let's Be Cops	冒牌條子
Life Feels Good	人生多美好
Fair Game	不公平的戰爭
Midnight Hair	夜半梳頭
The Big Short	大賣空
Upheaval of Jiawu	大變局之夢回甲午
The Merger	我們停戰吧
Birthday Card	生日卡片
Taken 3	即刻救援3
Something in the air	五月風暴
Kill Time	謀殺似水年華
Safe (2011)	火線反擊
Lion	漫漫回家路
Meet Miss Anxiety	我的早更女友
Father’s Lullaby	手機裡的眼淚
Pain & Gain	不勞而禍
The Storm	昨天再見
The Hateful Eight	八惡人
Armor Hero Atlas	鎧甲勇士之雅塔萊斯
Tender Woman	撒嬌女人最好命
Bushwick	全境警戒
Wonder MaMa	媽咪俠
Big Fortune Hotel	吉祥酒店
Attack on Titan：End of the World	進擊的巨人2
License to Wed	結婚糾察隊
Sweet Eighteen	甜蜜十八歲
Over the Sky	飛躍地心
Reprise	愛重奏
kuiba	魁拔
Star Trek Into Darkness	闇黑無界：星際爭霸戰
Mommy	親愛媽咪
Past and Present	七月半2：前世今生
Empties	布拉格練習曲
Dr. Seuss' The Lorax	羅雷司
Spring of the Life	大山裡的春天
72 Heroes	英雄喋血
Shut In	育陰房
The Back-up Plan	備胎女王
Wu xia	武俠
Bitch Slap	惡女殺很大
Black Death	黑死病
A Simple Hero	超萌英雄
$upercapitalist	商戰
Short story at the West Gate	我的西門小故事
Gu Bao Qi Yuan	古寶奇緣
Warrior	勇者無敵
Guia in Love	燈塔下的戀人
Meet Dave	大衛特大號
Red Sparrow	紅雀
Her Love Boils Bathwater	幸福湯屋
Men in the city 2	熱戀攻心
Genova	情留吉諾瓦
Anchorman 2: The Legend Continues	銀幕大角頭2：傳奇再續
The Way We Dance	狂舞派
Shanghai Noir	暴走神探
Keening Woman	哭喪女
Thermae Romae	羅馬浴場
League of Gods	封神傳奇
Charlie Countryman	這該死的愛
Dancing Without You	背著你跳舞
The Bodyguard	特工爺爺
Addicted	危情癮難耐
Mood Indigo	泡沫人生
BETELNUT GIRLS	櫥窗人生
A Nail Clippers Romance	指甲刀人魔
Harry Potter and the Half-Blood Prince	哈利波特6:混血王子的背叛
Safe	火線反擊
Nowhere to run	封門詭影
The Place Beyond the Pines	末路車神
Saint Laurent	巴黎聖羅蘭
Love Without Distance	土豪520
Alvin and the Chipmunks: Chipwrecked	鼠來寶3D
Good Night	愛上試睡師
Who in the Pool	恐怖游泳館
Human Capital	人命大富翁
Me Myself and Mum	媽媽要我愛男人
May Day 3DNA	五月天追夢3DNA
The Vanished Murderer	消失的兇手
An Inspector Calls	浮華宴
The Eye	變眼
The Shape of Water	水底情深
The Dangerous Affair	零點殺機
The Boys Are Back	型男親情日記
Ramona and Beezus	蕾蒙娜和姐姐
Money Monster	金錢怪獸
Pink Lady：Lover Run	粉紅女郎·愛人快跑
The Bell Of Love	愛的鐘聲
The Wolf of Wall Street	華爾街之狼
The Spirit	閃靈俠
ドラえもん　のび太のひみつ道具博物館	哆啦A夢2013
Split	分裂
Happy Panda	我是大熊貓
All The Money In The World	金錢世界
Tomorrowland	明日世界
Twenty Feet from Stardom	伴唱人生
Peepli Live	霹靂來唬秀
My Lucky Star	非常幸運
The Housemaid	下女
Alvin and the Chipmunks - Chipwrecked	鼠來寶3
The Lovely Bones	蘇西的世界
100 metros	100公尺的人生
Eloise	療養怨
Saw: Legacy	奪魂鋸8
A Very Harold & Kumar 3D Christmas	豬頭漢堡包3
The Women	女人至上
Hugo	雨果的冒險
Blood of Youth	少年
I Love You, Too	戀愛排班表
The Refuge	逐愛角落
Oh Boy	噢！柏林男孩
Fall of Ming	大明劫
A Film Unfinished	未完成的電影
Dangrous Liaisons	黑色終結令
The Stolen Years	被偷走的那五年
Brave Rabbit 2 Crazy Circus	闖堂兔2：瘋狂馬戲團
Night Peacock	夜孔雀
Contraband	禁運品
Seer V	賽爾號大電影4：聖魔之戰
Masquerade	雙面君王
I am big star	我是大明星
Chocolate	致命巧克力
Room 704	淒靈室
Lover Run	男生女生騙
Machi Action	變身
Kong: Skull Island	金剛:骷髏島
I, Frankenstein	科學怪人：屠魔大戰
The Tourist	色遇
Legend of Chinese Titans	封神傳奇
The Hunger Games: Catching Fire	飢餓遊戲：星火燎原
The Vault	惡靈金庫
Love and Other Drugs	愛情藥不藥
45 Years	45年
Rams	羊男的冰島冒險
The House	樓
Wall Street: Money Never Sleeps	華爾街：金錢萬歲
Mark Of Youth	全城高考
No Puedo Viver Sin Ti	不能沒有你
The Twins' Code	孿生密碼
Xin Kang Ding Qing Ge	康定情歌
My Undercover Husband	我的老公是臥底
42	傳奇42號
The Snow White Murder Case	白雪公主殺人事件
Burnt	天菜大廚
Peak: The Rescuers	岳：冰峰救援
Jump Ashin！	翻滾吧！阿信
The Watch	巡邏驚很大
Act of Valor	海豹神兵：英勇行動
The Dictator	大獨裁者落難記
About Last Night	誘惑·夜風流
White God	忠犬追殺令
Holiday	逃獄風雲
Jeruzalem	聖獄:耶路撒冷
The Fatality	絕魂印
Breaking The Waves	激浪青春
Oh My God	從天兒降
The Gangster's Daughter	林北小舞
Zootopia	動物方城市
The Fierce Wife Final Episode	犀利人妻最終回：幸福男·不難
Learning to Drive	愛情停看聽
I Romancing In Thin Air	高海拔之戀II
Super 8	超級8
Blair Witch	追殺厄夜叢林
Knowing	末日預言
Whiplash	進擊的鼓手
I Served the King of England	我曾伺候過英國國王
Focus	決勝焦點
Paranormal Activity: The Marked Ones	鬼入鏡：詛咒
Kizumonogatari: I Tekketsu-hen	傷物語: 鉄血篇
Sinister 2	凶兆2：雙瘋
Mr. & Mrs. Player	爛滾夫鬥爛滾妻
The Line	界限
Black & White Episode I: The Dawn of Assault	痞子英雄首部曲：全面開戰
Star Trek 3	星際爭霸戰3
Ip Man 3	葉問3
How I Ended This Summer	我如何度過這個夏天
Hui Xiang Dou	回鄉逗兒
The Bar	抓狂酒吧
The Most Beautiful Day	最酷的一天
The Wailing	哭聲
Run Papa Run	一個好爸爸
Mortician)	臨終囧事
One Day	有一天
A Murder Besides YanHe River	黃克功案件
The Sitter	驚夜誰保姆
Winter's Tale	冬季奇蹟
Memories of My Melancholy Whores	我的鬱妓回憶錄
Robot & Frank	機器人與法蘭克
Uncle Boonmee Who Can Recall His Past Lives	波米叔叔的前世今生
Rescripts Bout Peony Fairy	牡丹仙子之皇帝昭曰
That Summer	偷歡
Maggie	我的殭屍女兒
From Prada To Nada	小姐好窮
Pink & Gray	紅的告別式
Inside	鮮胎活剝
The Last Stand	重擊防線
The Guillotines	血滴子
Fireworks, Should We See It from the Side or the Bottom?	煙花
WINGS	最長的擁抱
Boonie Bears: Mystical Winter	熊出沒之雪嶺熊風
Echoes of Rainbow	歲月神偷
12 Years a Slave	自由之心
Partners In Crime	共犯
Wild Mouse	放生員工請注意
Say Yes	101次求婚
An Inconvenient Sequel: Truth to Power	不願面對的真相2
The Rebound	愛情逆轉勝
The Three Stooges	三個臭皮匠
Bandslam	搖滾未來
Lost In Thailand	人再囧途之泰囧
The Circle	直播風暴
Mission Incredible: Adventures On The Dragon's Trail	喜羊羊與灰太狼之開心闖龍年
Stopped on Track	瀕臨邊緣的人
Miss Pettigrew Lives for a Day	B咖妙管家
The Good Lie	扭轉命運的樂章
Paradox	殺破狼•貪狼
Doubt	誘·惑
Standing Ovation	舞動青春
Catfish	非識不可
Parkland	關鍵目擊
Citizen Dog	大狗民
What's Your Number?	先生你哪位
Boys	田徑男孩
Sweet World	鳳凰台
The Mutant Chronicles	突變末日
Sky Ladder	天梯
Gantz	殺戮都市
Spare Parts	夢想啟動
No Strings Attached	飯飯之交
Kill the Messenger	告密者
Tale of The Rally	龜兔再跑
The Mountain Between Us	絕處逢山
Cross	第6誡
Night Catches Us	夜晚吞噬了我們
The Man From U.N.C.L.E.	紳士密令
City Under Siege	全城戒備
The Flowers of War	金陵十三釵
Distance	再見，在也不見
Kungfu Boys	龍拳小子
ParaNorman	派拉諾曼：靈動小子
The Temptation in Lincang	臨滄的誘惑
Ma' Rosa	私法拘留
Tea Fight	鬪茶
Under the Skin	肌膚之侵
The Skin I Live In	切膚慾謀
River Road	家在水草豐茂的地方
The Way, Way Back	三分男孩
Jungle Master&#160;: the Candy World	糖果世界大冒險
The Bounty	懸紅
what on earth have i done wrong?!	情非得已生存之道
The Girl on the Train	列車上的女孩
Abraham Lincoln: Vampire Hunter	吸血鬼獵人：林肯總統
Big Game	總統遊戲
Eat, Pray, Love	一個人的旅行
Hong Kong Trilogy	香港三部曲
Gangster Payday	潛龍風雲
Blood Stained Shoes	繡花鞋
Life of Pi	少年PI的奇幻漂流
Eaters	大胃王
Paper Towns	紙上城市
The Drudgery Train	苦役列車
Toy Story 3	玩具總動員3
The Princess and the Frog	公主與青蛙
Finding Sayun	不一樣的月光
Weeds on Fire	點五步
Blade Runner 2	銀翼殺手2
Parking	停車
地下鉄（メトロ）に乗って	穿越時空地下鐵
Magic Mike	魔力麥克
Where‘s the dragon？	龍在哪裡？
Night Flight	愛,不怕
Gone for a Dance	花漾漫舞
Jump Ashin!	翻滾吧！阿信
Naked Ambition	豪情3D
Blackway	反擊
Haunted Campus	超自然研究會
Texas Chainsaw 3D	德州電鋸殺人狂3D
Good Love Again	再愛一次好不好
Midnight Record Search	午夜尋訪錄
The Angels' Share	天使威士忌
Cloudy with a Chance of Meatballs 2	食破天驚2
21 Jump Street	龍虎少年隊
Bad Girl	女孩壞壞
End of Watch	火線赤子情
Faithball	天后之戰
Lost In Panic Room'	密室之不可告人
N+N	N+N
Ferdinand	萌牛費迪南
Vitus	想飛的鋼琴少年
Jack Of All Traces	神通鄉巴佬
Ben-Hur	賓漢
Finding Mr. Right 2	北京遇上西雅圖之不二情書
Papa	洛杉磯搗蛋計劃
Beijing Flickers	有種
Cherry Returns	那年夏天你去了哪裡
Friday The 13th	黑色星期五
The Hunger Games: Mockingjay – Part 1	飢餓遊戲：自由幻夢 PART I
Net I Die, Drop dead gorgeous	魍美
Gomorra	罪惡之城娥摩拉
Long Long Time Ago 1	我們的故事1
SPL 2	殺破狼2
Anniversary	紀念日
The Next 11 Days	冰雪11天
Night Fall	大追捕
Helios	赤道
Forget All Remember	37次想你
The Fourth Portrat	第四張畫
Hannah Montana	孟漢娜3D立體演唱會
The Four Cupids	四個丘比特
Hushed Roar	咆哮無聲
Tales Dark 1	迷離夜
Hide And Never Seek	厄夜直播
Warriors of the Rainbow	賽德克·巴萊
Chao Shi Kong Jiu Bing	超時空救兵
Disconnect	疏離世界
Qing Jia Guo Nian	親家過年
Battle: Los Angeles	洛杉矶之战
Premium Rush	超急快遞
Boyhood	年少時代
Love is the Last Word	廬山戀2010
Snowpiercer	末日列車
Splinter	異形魔種
Strange Battle	荒村怨靈
The Match	擊戰
Love Is Not NG	愛情不NG
The Day of Noah 2 Apocalypse	挪亞方舟驚世啟示2
The Class	我和我的小鬼們
See You Again	奇幻同學會
My House	鬼地方
Thousand Year Love	雲之錦
After the Wedding	婚禮之後
Bottle Shock	戀戀酒鄉
Bourne 5	神鬼認證5
Blue is the Warmest Color	藍色是最溫暖的顏色
Triumph in the Skies	衝上雲霄
Titanic 3D	鐵達尼號3D版
Gulu Mermaid	咕嚕咕嚕美人魚
James Cameron's Deepsea Challenge 3D	深海挑戰3D
The Signal	詭異訊
Kedi	愛貓之城
Music And Dream	恐怖照相機
Die Xian Gui Tan	碟仙詭譚
Beloved	親愛
A la mala	一個壞女孩
Yellow River Aria	老腔
Hardcore Henry	超狂亨利
Summer’s Tail	夏天的尾巴
Vampires Suck	吸血鬼了沒
Desierto	最後一次自由
Right Mistake	將錯就錯
I Am Love	我愛故我在
On The Way	我在路上最愛你
Love Evolutionism	愛情進化特區論
Horrible Bosses 2	老闆不是人2
Who is Crying at Midnight	夜半哭聲
The Good, the Bad and the Weird	神偷獵人斷指客
The Days of Noah 2: Apocalypse	挪亞方舟驚世啟示2
Will You Still Love Me	妳是否依然愛我
In Bruges	殺手沒有假期
Albert Nobbs	變裝男侍
Battlefield America	舞林對決
Harpoon	驚魂遊戲
Upstream Color	逆流色彩
Killers	刺客公敵
Precious Cargo	終極飆靶
Fracture	破綻
The Basenent	地下室驚魂
Something Borrowed	結婚友沒友
Crazy Crazy	瘋狂的瘋狂
Tale of Three Cities	三城記
The Social Network	社群網戰
Go Grandriders	不老騎士
Lost In Panic Cruise	密室之不可靠岸
1+1	1+1
Legend of A Rabbit	兔俠傳奇
Big Hero 6	大英雄天團
Body Of Lies	謊言對決
Hotel Transylvania	尖叫旅社
Overheard 3	竊聽風雲3：土豪爭霸
Rise: Blood Hunter	獵殺鬼世界
Dive In	這一刻，愛吧！
Stung	蜂狂
Retribution	叫魂
Kai Xin Chao Ren	開心超人
The Golden Era	黃金時代
Distant	遠方
The Call	絕命連線
Disney High School Musical: China	歌舞青春
Chasing Mavericks	衝破極限
It Takes Two to Tango	車拼
The Revenant	神鬼獵人
I Am Not Madame Bovary	我不是潘金蓮
Zhu Zhu Xia Zhi Jiong Jiong Wei Ji	豬豬俠之囧囧危機
Flying Butterfly	蝴蝶飛
Legend	金牌黑幫
My Golden Days	那些年狂熱戀情
Battle of Cuju	蹴鞠
17 Again	回到17歲
Ma Xiaole and His Toys	馬小樂之玩具也瘋狂
Big Stan	猛男姦獄
The Apostles	詭鎮
Legend of The Aroma City	芳香之城傳奇
Dirty Grandpa	阿公歐買尬
Tales Dark 1</span></i><span lang="en" xml:lang="en">/<i>Tales from t	鬼夜
Zhong Kui: Snow Girl and The Dark Crystal	鍾馗伏魔：雪妖魔靈
Camp X-Ray	戰犯風暴
The World's End	醉後末日
A Little Chaos	美人情園
Drunkard, The	酒徒
The Hundred-Foot Journey	美味不設限
I Am Legend	我是傳奇
Anywhere，Somewhere，Nowhere	到不了的地方
Center of My World	我的觸男日記
THE PALACE	宮鎖沉香
The Love of Siam	愛在暹邏
Secret of the Wings	奇妙仙子：冬森林的秘密
Big Big Man	大人物
The Haunted Cinema	恐怖電影院
Amal	窮得只剩下錢
Sleeping With Other People	愛睡在一起
Deepwater Horizon	地平線
The Penguins of Madagascar	馬達加斯加爆走企鵝
Following the Donkey	人在驢途
Another Year	又一年
Taken	即刻救援
Masters In Forbidden City	我在故宮修文物
Chef	五星主廚快餐車
The Crossing	太平輪：驚濤摯愛
Still Life	無人出席的告別式
Hot Blood Band	熱血男人幫
More Than Close	近在咫尺的愛侶
Inferno 3D	全面封鎖
Room	不存在的房間
Harry Potter and the Deathly Hallows - Part 1	哈利波特7
Virtual Recall	異空危情
Ninja Turtles	忍者龜
Casino Jack	A金政客
Taipei Exchanges	第36個故事
The Inerasable	被詛咒的房間
Don't go breaking my Heart 2	單身男女2
House of Pleasures	巴黎妓院回憶錄
Time Flies Soundlessly	歲月無聲
Grand Piano	關鍵琴聲
One Night To Be Star	一夜成名
New Year's Eve	新年前夜
Snitch	限時翻供
Turn Around	美人邦
CJ7	長江七號
The Shack	心靈小屋
Beyond the Gates	勇闖地獄門
The Flock	屍蹤現場
SO YOUNG	致我們終將逝去的青春
Balala The Fairies-The Magic Trial	巴啦啦小魔仙之魔法的考驗
Help,I Shrunk My Teacher	我把老師縮小了
Roco Kingdom 3<	洛克王國3：聖龍的守護
Mr. Deng Goes to Washington	旋風九日
My Ten Million	我的1000萬
30 Gum Lung Jaew	女人30又怎樣
The King's Speech	王者之聲：宣戰時刻
The Gunman	全面逃殺
The Founder	速食遊戲
Clouds of Sils Maria	星光雲寂
Bittersweet	愛上有機男
Inception	全面啟動
Love in Late Autumn	愛在深秋
Elite Squad	精銳部隊
The Dilemma	劈腿困境
The Mighty Macs	戰勝逆境
Aftershock	唐山大地震
The Greatest Showman	大娛樂家
Me, 19	我，十九歲
Joyful Reunion	飲食男女2：好遠又好近
Magic Wonderland	魔幻仙蹤
Morgan	魔詭
The Accountant	會計師
Diaries of the Cheating Hearts	擒愛記
The DUFF	恐龍尤物
For Love or Money	露水紅顏
Naked Harbour	縱情城市
Twin Spirit	雙生靈
Homefront	最後防線
Marguerite	巴黎走音天后
Caesar Must Die	凱薩必須死
Closest Love to Heaven	今天的吉良同學
Frozen	空中驚魂夜
Clash	衝突的一天
Lazy Hazy Crazy	同班同學
3 Days to Kill	特務殺很大
A story about banana	香蕉傳奇
Let’s Go, JETS!	青春後空翻
Fire With Fire	封火線
：Marley & Me	馬利與我
Nanny McPhee Returns	魔法褓母麥克菲2
ヱヴァンゲリヲン新劇場版：序	新世紀福音戰士
The Arti&#160;: The Adventure Begins	奇人密碼－古羅布之謎
Silent Witness	全民目擊
One Nation Two Cities	一國雙城
Flash Point	導火線
East Meets West 2011	東成西就2011
Colossal	柯羅索巨獸
Wreck-It Ralph	無敵破壞王
At Cafe 6	六弄咖啡館
Floraand Fauna’s War	動植物大戰
Seediq Bale II	賽德克·巴萊(下)：彩虹橋
Legend of The Moles-Treasure of Scylla	摩爾莊園2海妖寶藏
Fool's Gold	傻愛成金
Happy Feet 2 in 3D	快樂腳2
Edge of Tomorrow	明日邊界
Jia Wu Da Hai Zhan	一八九四・甲午大海戰
Duplicity	口是心非
Fragrance of Flowers	花香
The Adventures of Little Piglet Banna	小豬班納之夢想大帽險
Child 44	失控獵殺：第44個孩子
Vow of death	求神問鬼
The Wedding Ringer	伴郎友沒友
Another Woman's Face	第2張臉
Jack Reacher	神隱任務
The Lion King 3D	獅子王3D
Marina Abramovic: The Artist Is Present	凝視瑪莉娜
Tale of Tales	異色童話集
The Great Magician	大魔術師
In His Chart 2	神的病歷簿2
The Switch	精選完美男
G.I. Joe: Retaliation	特種部隊2：正面對決
Greenberg	愛上草食男
The Kite Runner	追風箏的孩子
Who Sleeps My Bro	睡在我上鋪的兄弟
Lawless	野蠻正義
Oculus	鬼遮眼
Arbitrage	套利交易
Sleepwalker in 3D	夢遊3D
Visions	冥視
Chevalier	非普通型男
Ana, Mon Amour	我為愛
Fire of Conscience	火龍
Victoria and Abdul	女王與知己
The Accidental Husband	我的意外老公
Operation Chromite	代號: 鐵鉻行動
孤高のメス	孤高的手術刀
Whoever	愛誰誰
Spectre	007：惡魔四伏
Camille Rewinds	再一次初戀
Saturno contro	熾愛
Super Model	T台魔王
Natalie	娜妲莉的情人
Teenage Mutant Ninja Turtles	忍者龜：變種世代
Secret Garden	秘密花園
Frantz	雙面法蘭茲
708090 Love Story of Shenzhen	708090之深圳戀歌
St. Vincent	歐吉桑鄰好
3D Sex & Zen: Extreme Ecstasy	3D肉蒲團
Miss Meadows	甜心殺手
Prince of Tears	淚王子
Little Big Master	五個小孩的校長
Drive Angry 3D	3D怒火狂飆
We Are Your Friends	音浪青春
Love in a Puff	志明與春嬌
The Last Flight	北非謎情
Women Who Know How to Flirt Are the Luckiest	撒嬌女人最好命
The Rise of a Tomboy	女漢子真愛公式
A Dark Truth	黑暗真相
Go Angels Go! Taiwan Bike Holiday	天使去哪兒-台灣單車假期
Amor	感情生活
Time To Love	新步步驚心
Colombiana	黑蘭煞
Passion Island	熱愛島
Meet the Fockers	門當父不對3
Didi's Dream	吃吃的愛
The Pain of Others	海巡尖兵
The Age of Adaline	時空永恆的愛戀
Speed Angels	極速天使
Red Sky	殲滅天際線
Nebraska	內布拉斯加
I Belonged to You	從你的全世界路過
Under The Influence	戒菸不戒酒
Angry Kid	憤怒的小孩
The Master	師父
Revelation of Ghost Marriage	冥婚啟示
母べえ	X檔案:母親
The Children of Huang Shi	黃石任務
Heli	毒粉風暴
Great Rescue	非常營救
Lives In Flames	起勢搖滾
CUG: King of Heroes	西遊記之大聖歸來
Mida	夢見
The Better Angels	少年林肯
The Monkey King	西遊記之大鬧天宮
Fly, Kite Fly	老鷹想飛
Miss Sloane	攻敵必救
Pinoy Sunday	台北星期天
White Bird in a Blizzard	暴風雪中的白鳥
Maze Runner: The Scorch Trials	移動迷宮：焦土試煉
Miss Julie	茱莉小姐
Jupiter Ascending	朱比特崛起
Get Together	逗陣ㄟ
Oblivion	遺落戰境
ZAPP	蘋行世界之程
Bangkok Dangerous	無聲火
Sector 7	7號禁地3D
Tangerine	夜晚還年輕
Women Who Flirt	撒嬌女人最好命
Fairy Tale Killer	追兇
Hai Qi, Da Ta Ge Gui Zi	嗨起，打他個鬼子
Make Room	A片現場不NG
No Breathing	屏息
The Princess of Montpensier	公主和她的情人
Dead Snow 2: Red vs. Dead	冰血奇緣
Golden Age	黃金時代
Xue Cai	血彩
Free Birds	火雞反擊戰
Dark Skies	黑暗天際
Frank	法蘭克
Ghost Neighbor	隔壁驚魂
Tiny Times 3.0	小時代：刺金時代
All Because Of Love	痴情男子漢
Legend Of The Swordsman	刀客外傳
Patrik, Age 1.5	養子15歲
Dope	嘻哈宅男真藥命
怪談	色凶怪談
Pirates of the Caribbean: Dead Men Tell No Tales	神鬼奇航5
Le Havre	溫心港灣
Late Bloomers	內衣小舖
Jonah Hex	疤面大鏢客
The White Storm	掃毒
Life Risking Romance	危險羅曼史
Lu Zhen Chuan Qi	鹿鎮傳奇
The Tale of the Princess Kaguya	輝耀姬物語
Pecoross’ Mother And Her Days	去看小洋蔥媽媽
Stone	色獄心機
Return The Money	啊朋友還錢
Fly me to Venus	星語心願之再愛
Crazy Racer	瘋狂的賽車
Robbery	老笠
The Single Moms Club	單身媽媽俱樂部
Once Upon a Time in Tibet	西藏往事
Nelly	她的應召日記
Rabbit Hero	超能兔戰隊
Bears	熊世界
Angel Please Kiss Me	天使請吻我
Haunting Lover, The	借室還魂
Small Talk	日常對話
Believe In Love	初戀淺規則
The Tree In The Rain	雨中的樹
Camel Caravan	駱駝客
The Adventures of Sinbad 2013	辛巴達歷險記2013
Sisters	瞎趴姊妹
Lee's Adventures	李獻計歷險記
The Rooftop	天台
Blame It On The Phone	都是手機惹的禍
O'Horten	霍頓的鐵道人生
Una	最愛你的人是我
Far from the Madding Crowd	遠離塵囂：珍愛相隨
Extraction	終極救援
Fruitvale Station	奧斯卡的一天
Girl$	囡囡
Year One in the North	北之零年
Berlin Syndrome	顫慄柏林
Argo	亞果出任務
Girls Trip	閨蜜假期
Avatar	阿凡達:特別版
The Taste of Youth	少年滋味
Dream Holiday	夢幻佳期
A Christmas Tale	屬於我們的聖誕節
Loose Cannons	愛情流彈
Treasure Hunter	刺陵
She Remembers, He Forgets	哪一天我們會飛
Rudolf the Black Cat	黑貓魯道夫
Sweet Home	屠屍館
The Road Less Traveled	一路有你
Shelter	藏身處
National Treasure 2	國家寶藏2
Sand Clock	砂時計
Death of a Superhero	愛情超能量
Once Upon a Time in the Old Bridge	大峰祖師
Ghosts of Girlfriends Past	舊愛找麻煩
Predestination	超時空攔截
My Original Dream	我的青春期
House at the End of The Street	街角最後那棟房子
Confucius	孔子：決戰春秋
Stand Up Guys	王牌雙賊
The Lone Ranger	獨行俠
And So It Goes	如此這般
The Homesman	逃離邊境
White House Down	白宮末日
The Humbling	百老匯熟男日記
War of Surrender	受降前夕
Ai De Xie Hou	愛的蟹逅
The Hunger Games	飢餓遊戲
Triad	紮職
Transsiberian	消失的旅客
Judy Moody and the NOT Bummer Summer	朱迪穆迪和不太糟糕的夏天
Mawen's Battle	馬文的戰爭
Marie Antoinette	凡爾賽拜金女
Hotaru the Movie: It's Only a Little Light in My Life	魚干女又怎樣
Zone Pro Site	總舖師
Sex and the City	慾望城市
Night Market Hero	雞排英雄
X-Men: Days of Future Past	X戰警：未來昔日
Atomic Blonde	極凍之城
Triumphantly Join Forces	大會師
The Palace on the Sea	海上皇宮
Jane Eyre	簡愛
Little Door Gods	小門神
No Regret	愛,不悔
The Hundred Regiments Offensive	百團大戰
Drug War	毒戰
Sherlock Holmes: A Game of Shadows	福爾摩斯2：詭影遊戲
Extraordinary Measures	愛的代價
The Ultimate Task	終極大冒險
Mr. Nian	年獸大作戰
The Together Project	獵愛大臨演
Killshot	生死一擊
The King of The Streets	街頭之王
Cruel & Unusual	迴路人生
The Post	郵報:密戰
Remember Me	驚動了愛情
The Laundryman	青田街一號
Sweeney Todd: The Demon Barber of Fleet Street	瘋狂理髮師
You Really Are My Lover	你是不是我的愛人
Ender's Game	戰爭遊戲
Red Riding Hood	血紅帽
Pleasant Goat and Big Big Wolf	喜羊羊與灰太狼之虎虎生威
Don’t Look Down	精油與肌膚
For More Sun II	夢想續航
Real Steel	鋼鐵擂台
Waltz for Monica	給莫妮卡的華爾滋
Song to Song	為妳唱的歌
Lao Ren Yuan	老人願
Limitless	藥命效應
The Nursery	育嬰室
The Last House on the Left	左邊最後那棟房子
Killing 7	追魂7殺
Baby Blues	詭嬰
Get Smart	特務行不行
The Kick	泡菜拳霸
HK: Forbidden Super Hero	瘋狂假面
Scouts Guide to the Zombie Apocalypse	殭屍教戰守則
21 and Over	醉後大學生
Fifty Shades Darker	格雷的五十道陰影2
Penguins of Madagascar	馬達加斯加爆走企鵝
My Mr.right	我的Mr. Right
Sweet of the Song	甜水謠
The Pretending Lovers	假裝情侶
Holding Love	Hold住愛
Dream Defender	守夢者
TWA-TIU-TIANN	大稻埕
Haunted Road	怨靈
Easy Virtue	愛,隨心所欲
Star Wars: Episode VII	星際大戰7
The Congress	虛擬天后
Katy Perry: Part of Me	凱蒂佩芮：做我自己
London Boulevard	倫敦大道
Love Is Strange	愛，不散
A Family Man	愛在回家時
Hallam Foe	在屋頂上流浪
The Mimic	仿聲靈
Here Comes Fortune	財神到
Five minutes to tomorrow	深夜前的五分鐘
Everlasting Broadcasting	永不消失的廣播
Teenage Mao Zedong	少年毛澤東
Transporter 3	玩命快遞3
My Old Classmate	同桌的妳
Rail Truck	軌道
Fifty Shades of Grey	格雷的五十道陰影
Shao Lin	新少林寺
The Fierce Wife	犀利人妻
Redemption	殺戒
Somebody to Love	我們約會吧
Rang Ai Zhan Fang	讓愛綻放
That's My Boy	我老爸卡好
Paranormal Activity 4	鬼入鏡4
The Third Way of Love	第三種愛情
Taare Zameen Par	心中的小星星
Antichrist	撒旦的情與慾
Happy life of YangGuang	楊光的快樂生活
The Gigolo	鴨王
ハンサム★スーツ	帥哥西裝
The Skeleton Road	怪談電影：屍骸之路
My Words, My Lies - My Love	愛情謊言
Cold War	寒戰
Mermaid	我的人魚女友
Wild	走出荒野
愛在愛情空窗期	愛在愛情空窗期
Coco	可可夜總會
Time to Show	非秀不可
The Clan	大犯罪家
Full Speed	一路不順風
Tiny Times	小時代
Love On That Day	愛在那一天
My Beautiful Kingdom	我的美麗王國
Vanishing on 7th Street	消失在第七大街
Django Unchained	決殺令
Architecture 101	初戀築夢101
Wo De Lei Ren Nan You	我的雷人男友
Darkest Hour	最黑暗的時刻
Memento Mori	記憶拼圖
Mandela: Long Walk to Freedom	曼德拉:漫漫自由路
Ye Dian Gui Tan	夜店詭談
Death is Here 3	筆仙驚魂3
Breakup 100	分手100次
Bruno	G型
Love Is The Only Answer	人約離婚後
Self/less	換命法則
A Time in Quchi	暑假作業
Fake Fiction	摩登年代
Alice in Wonderland	魔境夢遊
To The Fore	破風
Samba	巴黎遇見愛
The Eyes of Dawn	黎明之眼
The Lost Bladesman	關雲長
The Mystery of Death&#160;: Pisces Jade Pendant	死亡之謎之雙魚玉佩
MAYDAY 3DNA	五月天3DNA
Star Wars: Episode VIII: Space Bear	星際大戰8
Carpooling Shock	詭拼車
Scent	香氣
Love Is Beautiful	愛,很美
Run, Fat Boy, Run	求愛馬拉松
Confession of Murder	我是殺人犯
Grudge pix	恐怖照相機
Wonder	奇蹟男孩
Silence	沉默
The Amazing Spider-Man 2	蜘蛛人驚奇再起2：電光之戰
Seventh Son	第七傳人
The Judge	大法官
Paterson	派特森
Heaven of Nestling	雛鳥的天空
The Big Wedding	婚禮大聯矇
One Chance	翻聲吧保羅
Hui Lan	蘭輝
Fright Night	吸血鬼就在隔壁
Wolf Totem	狼圖騰
The Odd Life of Timothy Green	小芽的口白人生
Baby Mama	寶貝媽媽
Buddha Mountain	觀音山
Correspondence	愛情天文學
Kong Fu Wing Chun	功夫·詠春
Impetuous Love in Action	緣來是遊戲
Annie	安妮
LA LA	我與拉拉
A Frozen Flower	霜花店:朕的男人
Chrysanthemum to The Beast	給野獸獻花
Yogi Bear	瑜珈熊
The Killer Who Never Kills	殺手歐陽盆栽
Single no more	光棍魔鬼終結者
The Imitation Game	模仿遊戲
Continent	後會無期
Pitch Perfect 3	歌喉讚3
...and LOVE	與愛
Massagist	索命暹羅之按摩師
Xiao Xiong De Xia Tian	小熊的夏天
Free State of Jones	烈火邊境
Live or death in Lop Nor	生死羅布泊
Chernobyl Diaries	重返車諾比: 鬼城實錄
Pick the Youth	皮克青春
The Eighth House	詭八樓
Mission Impossible – Rogue Nation	不可能的任務：失控國度
Unfriended	弒訊
The Peach of Taozhi	桃枝的桃
Inside Llewyn Davis	醉鄉民謠
Bangkok Love Story	曼谷愛情故事
Lost in Paradise	你是天堂愛是地獄
As above so below	忐忑
The Mummy: Tomb of the Dragon Emperor	神鬼傳奇3
Insistence	守株人
Doraemon the Movie: Nobita and the Island of Miracle	哆啦A夢
The Hairy Tooth Fairy	金鑚鼠王
Magic in the Moonlight	魔幻月光
Love Never Dies	堵車
The Fault in Our Stars	生命中的美好缺憾
Liu Ru Shi	柳如是
Twilight	暮光之城
Driverless	無人駕駛
The Town	竊盜城
True Legend	全城熱戀熱辣辣
Sabotage	震撼殺戮
Sergeant Keroro the Movie 2	軍曹超劇場版2
Bridge Over Troubled Water	拔一條河
Mountains May Depart	山河故人
The Lost 15 Boys: The Big Adventure on Pirates' Island	喵星少年漂流記
The Rum Diary	衝擊特寫
From Vegas to Macau 2	澳門風雲2
The Queens	我是女王
Sex and the City 2	慾望城市2
Elle	她的危險遊戲
Heartfall Arises	破地獄
Sweet Heart	麻辣甜心
Newness	我們的愛情
Bright Wedding	璀璨的婚禮
Face To Face	正面迎擊
Spanish Movie	傻瓜大進擊
Alita: Battle Angel	艾莉塔:戰鬥天使
Hong Lin Jin	紅領巾
Exodus: Gods and Kings	出埃及記：天地王者
A Moment Of Love	回到愛開始的地方
27℃-Loaf Rocks	世界第一麥方
Body	通靈診療室
Rise Of The Legend	黃飛鴻之英雄有夢
Forever Enthralled	梅蘭芳
The Last Exorcism Part II	最後大法師2
A Land Without Boundaries	無界之地
Where is the paradise	情緣廊橋
Special Female Force	辣警霸王花
Bunshinsaba	筆仙
Deep in the Heart	心迷宮
Battle Of Hip Hopera	終極舞班
The Frog Kingdom	青蛙王國
Valley of Love	愛重逢以後
The Land Is So Rich in Beauty	蘭亭 (電影)
Kungfu Cyborg	機器俠
The Intouchables	逆轉人生
Don't Go Breaking My Heart	單身男女
Wolf Warriors	戰狼
The Expendables 3	浴血任務3
Saving Mother Robot	瑪德2號
7 Love Design	相愛的七種設計
Make Up	命運化妝師
Rubber	超能輪胎殺人事件
Bounty Hunters	賞金獵人
Sleepless Fashion	與時尚同居
Take Shelter	歷劫重生
Xiaoming & His Friends	小明和他的小夥伴們
Kick Ass Girls	爆3俏嬌娃
I'm Not There	搖滾啟示錄
Warrant the Reborn	催命符之劫後重生
Beyond the Bounds	越位者
Wang Mao	我不是王毛
Dracula: Untold	德古拉：永咒傳奇
Neverland	夢幻島
Sex &amp; Chopsticks 2	金瓶梅2
Slow West	西部緩慢之死
High Strung	舞力重擊
So Luckly	槓上開花
Will You Still Love Me Tomorrow?	明天記得愛上我
Paul Blart: Mall Cop 2	百貨戰警2
A Street Cat Named Bob	遇見街貓BOB
Detective Gui	宅女偵探桂香
The Final Lesson	最後一堂課
Cannot Prove	無法證明
The Grand Budapest Hotel	歡迎來到布達佩斯大飯店
Blitz	私法制裁
Horrible Masion In Wild Village	荒村凶間
Feng Shui	萬箭穿心
Me, Myself and Her	不只是閨蜜
Murder on the Orient Express	東方快車謀殺案
花より男子ファイナル	流星花園
In the Heart of the Sea	白鯨傳奇：怒海之心
White Vengeance	鴻門宴
Wrath of Vajra	金剛王：死亡救贖
Our Little Sister	海街日記
The Road to Mandalay	再見瓦城
Wanted	刺客聯盟
The Space Between Us	愛上火星男孩
Crank: High Voltage	快克殺手2
Perfect Baby	巴黎寶貝
少年メリケンサック	少年手指虎
Lady of the Dynasty	王朝的女人·楊貴妃
Terminator Salvation	魔鬼終結者4
From Paris With Love	間諜遊戲巴黎
A Tale of Love and Darkness	愛與黑暗的故事
Percy Jackson & the Olympians: The Lightning Thief	波西傑克森：神火之賊
Million Dollar Crocodiler	百萬巨鱷
Zack and Miri Make a Porno	淫幕初體驗
What's So Special About Rina	麗娜有甚麼
The Beauty	鬥豔
The Last Painting	自畫像
The Best Love	我爸比我小四歲
The Vow	愛重來
Vampire Warriors	殭屍新戰士
Prince of Persia: The Sands of Time	波斯王子：時之刃
Hand in Hand	牽阮的手
Youth in the Air Outlet	風口青春
Rio 2	里約大冒險2
The Girl with the Dragon Tattoo	龍紋身的女孩
Insidious Chapter 3	陰兒房3
Sex and Death 101	101夜情
No Reservations	料理絕配
Rough Night	女狼嗨到趴
Unknown	狙擊陌生人
The Beloved	重生愛人
Scary Road Is Fun	陌路驚笑
The Last Song	最後一首歌
The Muppets	布偶
Code Name: The Cleaner	霹靂鳥探
Promise	深情約定
Common Heroes	貧民英雄
Home: Love, Happiness, Remembrance	擁抱幸福擁抱愛
Now is Good	愛正好
Ghost Rider: Spirit of Vengeance	惡靈戰警2
You are the Apple of My Eye	那些年，我們一起追的女孩
Sword Master	三少爺的劍
Star Ant - Global Adventure	小螞蟻之環球大冒險
Beautiful Stupid Women	美麗笨女人
Armor Hero Emperor	鎧甲勇士之帝皇俠
Blue Jasmine	藍色茉莉
Ghost	食人島
The Kids Are All Right	性福拉警報
Saw VII 3D	奪魂鋸
Me Before You	我就要你好好的
Salt and Fire	鹽與火之歌
One Piece Film Z	航海王電影：Z
Arctic Tale	極地熊寶貝
Road Less Traveled	樂之路 (電影)
Hanky Panky	大釣哥
Remember	我記得
Jackie	第一夫人的秘密
The Expendables	浴血任務
The Elegy	熱土悲歌
Loyalty and Betrayal	忠誠與背叛
The Fantastic Four	驚奇4超人
Flirting In The Air	唐伯虎衝上雲霄
Tinker Bell	奇妙仙子
The Tall Man	巨魔人
Here Comes the Boom	肉腳擂台
Turandot	圖蘭朵
Sasha	第一次心動
Love of Gulu	姑魯之戀
Ghost Graduation	死也要畢業
Home Again	愛情齡距離
Pacific Rim	環太平洋
Good-For-Nothing Heros	請叫我英雄
Solitary Man	非關好男人
Hereafter	生死接觸
The Mummy	神鬼傳奇
西遊記之大鬧天宮	西遊記之大鬧天宮
If Not Us, Who?	捨愛其誰
Seven Years	愛呦,阿斗
Centurion	世紀戰魂
The Counselor	玩命法則
Citizenfour	第四公民
The Ghost Must Be Crazy	鬼也笑
R2B：Return to Base	R2B:獵鷹行動
Dream Flight	想飛
Tomb Robber	密道追蹤之陰兵虎符
The Unknown Woman	裸愛
Eating Out: Drama Camp	外出用餐4
Bao Ma Kuang Xiang Qu	寶馬狂想曲
I, Tonya	老娘叫譚雅
The Second Chance	帶ㄙㄞˋ男朋友
Golden Doll	古曼
John Wick 2	捍衛任務2
The Mysterous Family	神秘家族
Letters to God	寫給上帝的信
Birds Without Names	她不知道
Beauty and the Beast	新美女與野獸
Nim's Island	尼魔島
The Club	贖罪俱樂部
Adventure of the King, The	龍鳳店
Bahubali 2: The Conclusion	巴霍巴利王2
What Happens in Vegas	頭彩冤家
Who Under The Bed	床下有人
The Secret World of Arrietty	借物少女艾莉緹
Frankie and Alice	法蘭基與艾莉絲
The Struggle Of 80's	80後的獨立宣言
Mao's Last Dancer	毛澤東時代的最後舞者
I Love Hong Kong 2013	2013我愛HK 恭囍發財
In Case of Love	街角的小王子
The Kirishima Thing	聽說桐島退社了
Masterminds	笨賊樂盜家
The Treaty of Double Bed	雙人床條約
The Lego Movie	樂高玩電影
Mr. Magorium's Wonder Emporium	魔法玩具城
Devil and Angel	惡棍天使
Collide	偷天劫車手
A Little Bird	我是隻小小鳥
Heart of Stone	心之物語
127 Hours	127小時
Kidnap	綁架
Coco Before Chanel	時尚女王香奈兒
God of Fortune Inn	財神客棧
Emperor Holidays	爸爸的假期
The Way Back	亡命千萬里
The Bounty Hunter	賞金戀人：Ex檔案
Bottom line	絕對底線
Me and Earl and the Dying Girl	我們的故事未完待續
Tomorrow I Will Date with Yesterday's You	明天，我要和昨天的妳約會
Coming Back	回馬槍
Beyond the Hills	靈慾告白
Wild Desert	心跳戈壁
Child's Eye	童眼3D
Beautiful 2015	美好2015
A Walk in the Woods	別跟山過不去
Free Fire	玩命鎗火
Keep The Lights On	為你流的淚
Love is. . .Pyjamas	男人如衣服
Vampire Academy	吸血鬼學院
Game of Assassins	刺客
Beyond the Walls	我們的幸福時光
An Inspector's Calls	神探駕到
The Missing Piece	缺角一族
300: Rise of an Empire	300壯士：帝國崛起
The First Time	第一次
Meat Grinder	人肉麵線
Moneyball	魔球（電影）
Story of Taipei	台北物語
Team Spirit	巴黎交易員
Melody	腳趾上的星光
Adventure of The King	龍鳳店
Monte Carlo	山寨公主
Xuan Zang	大唐玄奘
Attack the Block	異星大作戰
Whip It	飆速青春
The Stool Pigeon	線人
Sky On Fire	沖天火
劇場版銀魂 完結篇　万事屋よ永遠なれ	銀魂完結篇
Taken 2	即刻救援2
The Haunted Drum	人頭蠱
Kon-Tiki	康提基號
Renoir	印象雷諾瓦
Starred Up	超危險人物
The Supernatural Events on Campus	校花詭異事件
The Babysitter	辣手保姆
War Witch	愛在戰火迷亂時
The Chinese Mayor	大同
The Help	姊妹
Marksman	快槍手
Song And Moon	行歌坐月
The Law Of Attraction	萬有引力
Brave	勇敢傳說
Invisible connection	天上掉下個林妹妹
SDU: Sex Duties Unit	飛虎出征
Love Will Tear Us Apart	我想和你好好的
Hui Buh: The Castle Ghost	瘋狂鬼幽靈
Dan in Real Life	老爸行不行
名探偵コナン　戦慄の楽譜	名偵探柯南12
Loves &amp; Movies	愛我就陪我看電影
The Empire Symbol	帝國秘符
From Vegas to Macau II	賭城風雲II
Qing Yan	青魘
Delete My Love	Delete愛人
Falling Flowers	蕭紅
G-Force	鼠膽妙算
Beginners	新手人生
Hong Yan Rong	紅顏容
Orz Boyz	囧男孩
King Arthur: Legend of the Sword	亞瑟:王者之劍
Memory	靈虐
Sweet Alibis	甜蜜殺機
Brick Mansions	玩命特區
All You Need is Love	落跑吧愛情
Come Back, Love	約定倒計時
Deception	桃色名單
Design Of Death	殺生
Monster Trucks	怪獸卡車
It's Love	白蛇傳說
Do You Believe?	你相信嗎
奇妙的旅程	奇妙的旅程
Angel	逐愛天堂
Eternal Moment	將愛情進行到底
The Dark Tower	黑塔
The walkers	行者
The Iron Lady	鐵娘子
デトロイト・メタル・シティ	重金搖滾雙面人
Untamed	慾望
Gone With Far	江湖論賤實錄
Youth Never Returns	既然青春留不住
Wall-E	瓦力
X戰警: 未來昔日	X戰警:未來昔日
Getaway	死路十條
Conspirators	同謀
Liberal Arts	愛情必修學
The Virginity Hit	怎樣失去童貞
Lost in Thailand	人再囧途之泰囧
Rob the Mob	搶劫暴徒
Abattoir	特厲鬼屋
Battle Spirit	戰酒
The Man with the Iron Fists	鐵拳男子
Flying Girl	飛天窯女
I Give It a Year	一年之癢
Amityville: The Awakening	陰宅2
Sex Appeal	寒蟬效應
10 Questions for the Dalai Lama	達賴喇嘛十問
Toys War	泰迪熊之玩具大戰
Seer 5	賽爾號大電影5：雷神索爾崛起
LOVE	愛
Mysterious Bullet	近距離擊殺
Love Transplantation	幸福快遞
Red Cliff 2	赤壁2:決戰天下
Treasure Hunt	無價之寶
Straight Outta Compton	衝出康普頓
10,000 BC	史前一萬年
Nobunaga Concerto: The Movie	信長協奏曲
Blind Massage	推拿
Jumanji: Welcome to the Jungle	野蠻遊戲
Fury	怒火特攻隊
CJ7: Super Q Team	長江7號：超萌特攻隊
Magic Mike XXL	舞力麥克：尺度極限XXL
Leo's Room	里歐的房間
I'm So Excited	飛常性奮
Hacksaw Ridge	鋼鐵英雄
Roco kingdom:the desire of dragon	洛克王國2聖龍的心愿
The Possession	聚魔櫃
The Precipice Game	魔輪
3688	想入飛飛
Smurfs: The Lost Village	藍色小精靈3
No Kidding	不是鬧著玩的
The Girlfriend Experience	應召女友
Alive Inside	如夢幻音：沈睡的記憶
Need For Speed	極速快感
Fast and Furious	玩命關頭4
TV Z	TV屍
High School Musical 3: Senior Year	歌舞青春3
Love Story	愛愛囧事
Ode to Time	四十年
Substitute Millionaire	做次有錢人
X-Men: The New Mutants	變種人
Love In Disguise	戀愛通告
Little Big Panda	熊貓總動員
RoboCop	機器戰警
Line Walker	使徒行者
Peace in Love	愛在墾丁─痞子遇到愛
Perfect Imperfection	我是處女座
Scary Market	嘿店
Laggies	大愛晚成
Salmon Fishing in the Yemen	飄洋過海愛上妳
The Forbidden Kingdom	功夫之王
The Glass Castle	玻璃城堡
Lao Hu Dou Yao Jia	老虎都要嫁
Hollywood Adventures	橫衝直撞好萊塢
Heaven Eternal, Earth Everlasting	80'後
For Colored Girls	有色女孩
Black Sheep	兒子老子
No Good Deed	危險行為
The M Riders Finding Pangu	萌學園：尋找磐古
At Café 6	六弄咖啡館
Flipped	怦然心動
The Nightmare Call	詭夢凶鈴
A Roar of Wolf Troops	狼兵吼
Piano Trojan	鋼琴木馬
48Hours	試睡員48小時
Kungfu style	特功明星
The Perks of Being a Wallflower	壁花男孩
Thor	雷神索爾
Taking Woodstock	胡士托風波
Castaway on the Moon	荒島愛
Pitch Perfect 2	歌喉讚2
Stand By Me	奮鬥
Scandal Maker	外公芳齡38
I Sell Love	販賣愛
Girls	閨密
For Greater Glory	更大的輝煌
Yin Lingzhi	黨的女兒尹靈芝
Sword of Hope	軒轅劍傳奇
Riddick	超世紀戰警：闇黑對決
Bunshinsaba 3	筆仙III
Sleuth	非常衝突
Peanuts	史努比
Maverick	菜鳥
Hong Mao Lan Tu Huo Feng Huang	虹貓藍兔火鳳凰
Yugo&Lala 2	神秘世界歷險記2
Dragon Ball Z: Battle of Gods	七龍珠Z劇場版
Hardcore Comedy	重口味
2012	2012
Peter Rabbit	彼得兔
The Drop	錢藏凶機
Curse of the Deserted	荒村公寓
Brooklyn	愛在他鄉
The Body	屍物招領
The Wildest Dream	最狂野的夢
Flying With Daddy	全能囧爸
The Story Of Zhou Enlai	周恩來的四個晝夜
The Way He Looks	愛情的模樣
The Message	風聲
You Don't Mess with the Zohan	特勤沙龍
The Emoji Movie	表情符號電影
Tomorrow Comes Today	你的今天和我的明天
Love Go Home	愛·回家
Singular Puzzle	異度迷局
The Locked Door	女人如花
Manglehorn	梅格漢的心靈鑰匙
Death and Glory in Changde	喋血孤城
Personal Tailor	私人訂製
Due West	一路向西
God man dog	流浪神狗人
Midnight Beating	午夜心跳
Little Boy	小男孩
My Boyfriends	我的男男男男朋友
Len and Company	搖滾不靠爸
Tammy	譚美
Adventure of Frog	青蛙總動員
The Storm Riders 2	風雲2
Seediq Bale	賽德克.巴萊(上):太陽旗
Vinodentro	魔鬼品酒師
Black Bear Forest	黑熊森林
Ip Man Final Fight	葉問：終極一戰
If You Are the One 2	非誠勿擾2
La Soga	屠夫之子
Irreplaceable	小鎮醫生
Live by Night	夜行人生
The Door With Dad's Love	當爸爸來敲門
One Times	我的少女時代
i Girl	iGirl 夢情人
Fading Wave	老炮兒
Ultimate hero	終極硬漢
Gold	金爆內幕
Love Detective	沒女神探
Knight & Day	騎士出任務
Detective Conan : Private Eye In The Distant Sea	名偵探柯南17
A Promise to the Kurichenko's	相伴庫里申科
When A Wolf Falls In Love With A Sheep	南方小羊牧場
Mission Milano	偷天特務
The Twilight Saga: Eclipse	暮光之城：無懼的愛3：蝕
She's Out of My League	辣妹愛宅男
The Danish Girl	丹麥女孩
Lan Kwai Fong	喜愛夜蒲
Fleet Of Time	匆匆那年
Dawn Break Up	天亮·分手
Tharlo	塔洛
Safe Haven	愛情避風港
Silver Linings Playbook	派特的幸福劇本
Fly Me to Venus	星語心愿之再愛
A Wedding Invitation	分手合約
Quartet	唱快人生
Last Of The Best	一個人的武林
Sinister	凶兆
Trolls	魔髮精靈
Love Sick	戀愛恐慌症
Don Quixote	魔俠傳之唐吉可德
The House That Never Dies	京城81號
Underworld 4	決戰異世界4
Stolperstein	絆腳石
Summer Hours	夏日時光
Confidence Of Banking Stockroom	鏢行天下前傳之庫丁之謎
Slumdog Millionaire	貧民百萬富翁
Rambo	第一滴血4
Showtime	用心跳
Elizabeth: The Golden Age	輝煌年代
My Ex-wife's Wedding	跟我的前妻談戀愛
Guardians	守護者聯盟
Scary Notes	恐怖筆記
Max	海軍忠犬馬克斯
マリと子犬の物語	心動奇蹟
The heart of desert	沙漠之心
Jack Ryan	傑克萊恩
相棒－劇場版－絶体絶命！42.195ｋｍ東京ビッグシティマラソン	相棒劇場版
Hippocrate	醫手遮天
Future Fighters	守兵衛
Twelve	花邊藥頭
Leatherheads	愛情達陣
The Concert	交響人生
Z for Zachariah	末日寂境
The Change-Up	玩咖尬宅爸
After the Storm	比海還深
Undercover Duet	猛龍特囧
McDull · Me & My Mum	麥兜．我和我媽媽
Princess and Seven Kung-fu Masters	笑功震武林
As time goes by in Shanghai	上海老爵士
The Lodge In The Woods	林中小屋
The Song Of Cotton	盛先生的花兒
The Insanity	你好，瘋子！
9-9-81	陰緣
Yellow Elephant	黃色大象
Repeat I Love You	影子愛人
Lover's Discourse	戀人絮語
Naked Ambition 2	豪情3D
Ants On a Shrimp	神廚東京壯遊記
Father's Lullaby	手機裡的眼淚
The November Man	特務交鋒
Simple Simon	阿蒙正傳
Yi Zhi Gou De Da Xue Shi Guang	一隻狗的大學時光
Oriental Chinese Dream	東方中國夢
7500	7500鬼航班
Miss Granny	重返20歲
Freeheld	扣押幸福
Like a Dream	如夢
Death Dowry	米香
Lady Chatterley	查泰萊夫人
For Love to Let Go	為愛放手
The Last Airbender	降世神通：最後的氣宗
100 Feet	顫慄100步
Des illusions	日落前與妳相遇
Silently Love	默守那份情
My Egg Boy	我的蛋男情人
Prince Orient House	東宮皇子
Marina	瑪麗娜之橋
Happy Little Submarines 4&#160;: Adventure of Octopus	潛艇總動員4：章魚奇遇記
Diary of a Wimpy Kid 2: Rodrick Rules	遜咖冒險王2
The Third Half	人生勝利組
Moana	海洋奇緣
Mirrors	凶鏡
Snow White And The Three Pigs	白雪公主和三隻小豬
Italian Race	少女車神
Dogtooth	非普通教慾
Your Name	你的名字
Xi You Ji	嘻遊記
The Destiny	江南愛情故事
August: Osage County	八月心風暴
Before I Wake	鬼撕眠
Atrange Bedfellows	枕邊詭影
Searching For Sugar Man	尋找甜秘客
Port of Return	靠岸
Insanity	暴瘋語
The Handmaiden	下女的誘惑
Love Tactics	愛情36計
The Bling Ring	星光大盜
Destiny of Love	換愛七日
Tomb Raider	古墓奇兵
Gulliver's Travels	格列佛遊記
So, I Married the Anti-fan	所以……和黑粉結婚了
Bunny and the Bull	史帝芬的奇幻旅程
Snatched	搶救千金
The Lazarus Project	撕裂記憶體
This Is Me	年少輕狂
The Blind Side	攻其不備
Vulgaria	低俗喜劇
Sweetheart Chocolate	甜心巧克力
A Separation	分居風暴
Are You Ready to Marry Me	我想結婚的時候你在哪
Knocked Up	好孕臨門
My Big Fat Greek Wedding 2	我媽的希臘婚禮
My Piano	我的小小鋼琴家
Party Girl	我媽媽是派對女孩
Midnight Train	午夜火車
Their Finest	他們的美好時光
容疑者Ｘの献身	嫌疑犯X的獻身
Ghost Child	鬼仔
That Awkward Moment	約會進行時
Chasing The Drangon	追龍
Wanderlust	隨心所欲
Woodlawn	橄欖球傳奇
Tomcat	愛是一隻貓
Dad, Where Are We Going? 2	爸爸去哪兒2大電影
Votage Extraordinaire 3D	鄭和1405：魔海尋蹤
Imprisoned&#160;: Surival Guide For Rich And Prodigal	媽寶蹲監日記
Admission	愛情招生處
Bad Blood	滅門
Hop	開運兔
Hubble 3D	哈柏太空之旅
Run All Night	一夜狂奔
Bad Grandpa	無厘取鬧:祖孫卡好
Our Island our Dreams	星月無盡
Frankenweenie	科學怪犬
The Spy Next Door	鄰家特務
The Great Buddha +	大佛普拉斯
Da Hai	大魚海棠
Kick-Ass 2	特攻聯盟2
The Old Cinderella 2	男神時代
Animal Kingdom	動物王國
Sadako 3D 2	貞子3D2
Live With A Thief	與賊同屋
This Is It	未來的未來
Neerja	妮嘉
The Green Inferno	食人煉獄
Yu-Gi-Oh!: The Dark Side of Dimensions	遊戲王:次元的黑暗面
Guardians of the Galaxy Vol. 2	星際異攻隊2
Detective Conan: The Sniper from Another Dimension	名偵探柯南18
The Ferryman	擺渡人
Viva	變裝皇后萬萬歲
All For Love	三個未婚媽媽
The Brain Man	腦男
Su Beng, the Revolutionist	史明·革命進行式
Onion from the boot of a Benz	奔馳的大蔥
The Seal of Love	秋之白華
The Age of Shadows	密探
While We're Young	青春倒退嚕
Aberdeen	香港仔
The Final Girls	驚叫少女
The Company Men	企業風暴
Tenchi: The Samurai Astronomer	天地明察
Les Miserables	悲慘世界
Schoolgirl Complex	私處
蛇にピアス	蛇信與舌環
I Do	我願意
Spell	屍油
Hannah Montana & Miley Cyrus: Best of Both Worlds Concert Tour	孟漢娜3D演唱會
Jesus Loves Me	天神愛光臨
Dumb Child	啞孩兒
And If We All Lived Together	六人行不行
Illusion Apartment	異度公寓
Out of the Dark	童靈眼
Hancock	全民超人
Love is Touch	愛情碰碰撞
The Chrysalis	女蛹之人皮嫁衣
The Autobots	汽車人總動員
Empire State	帝國警戒
Special ID	特殊身份
Take Me Home Tonight	今晚帶我回家
Devil	惡靈電梯
Shi Er Sheng Xiao Cheng Shi Ying Xiong	十二生肖城市英雄
Just Another Pandora's Box	越光寶盒
Shadows of Love	影子愛人
The Long Goodbye	被遺忘的時光
Sea Fog	海霧
ChangChenGhostStories	張震講故事之合租屋
The Go-Go Boys	電影狂人夢
The Coffin	棺材
The Unvanished Vapour	誰的青春不熱血之深流不息
Vantage Point	刺殺據點
S.P.L.2	殺破狼2
The Wages of Sin	水落石出
Song of the Phoenix	百鳥朝鳳
The Flying Swords of Dragon Gate	3D龍門飛甲
喜羊羊與灰太狼之虎虎生威	喜羊羊與灰太狼
The Imaginarium of Doctor Parnassus	帕納大師的魔幻冒險
Michael Kohlhaas	最後的正義
The Teacher	老師有問題
The Best Kids	小神來了
2002 The Unborn Child	鬼嬰廟
The Pork of Music	麥兜噹噹伴我心
Mars Needs Moms!	火星需要媽媽
Sacrifice	趙氏孤兒
Colorful mind	新魯冰花
Bitter Honey	甜蜜的哀傷
In Order of Disappearance	該死的順序
Run for Love	奔愛
Let it be	稍安勿躁
Chronicle	超能失控
My Virgin Land	我的處女地
Case 39	39號特案
Happy Little Submarine Magic Box of Time	潛艇總動員：時光寶盒
Watch Out For The Bear	熊出沒注意
Dinotasia	荷索之恐龍夢奇地
The A-Team	天龍特攻隊
Fantastic Four: Rise of The Silver Surfer	驚奇四超人2
Doukyuusei	同級生
Cure	金不換
Hell and Back	地獄之旅
General's Goblet	奪樽
心が叫びたがってるんだ	好想大聲
Monsters vs. Aliens	怪獸大戰外星人
For A Few Bullets	快手槍手快槍手
Carriers	絕命帶原者
He's Just Not That Into You	他其實沒那麼喜歡妳
The Boundary	全城通緝
Underworld: Rise of the Lycans	決戰異世界3
The Dark Knight Rises	黑暗騎士：黎明昇起
Buddy Cops	刑警兄弟
The Grow	金箍棒傳奇
Fight Up	激戰黎明
Admission by Guts	驚魂電影院
Love Lifting	高舉愛
A Man Called Ove	明天別再來敲門
Cherry Blossoms	當櫻花盛開
What If...	假如時光倒流
Starfish	我的海星爸爸
Twelve Nights	十二夜
Rookie	菜鳥
Soul Mate	七月與安生
We Not Naughty	孩子不壞
Sock’n Roll	台灣黑狗兄
The Diabolical	異次元凶間
Love Actually... Sucks	愛很爛
True Grit	真實的勇氣
I Love Hong Kong 2	2012喜上加喜
Eden	巴黎電幻世代
THE FOUR	四大名捕
Mr. Charming	醜男大翻身
Wetlands	潮濕地帶
Conviction	非常上訴
The Dragon Pearl	尋龍奪寶
Beyond Beauty - Taiwan from Above	看見台灣
Eva Braun	情慾莊園
A Royal Affair	皇家風流史
Cloverfield	柯洛弗檔案
Three Monkeys	三隻猴子
Permanent Residence	永久居留
The Zookeeper's Wife	園長夫人:動物園的奇蹟
Attabu II	阿罩霧風雲─落子
The Hangover Part III	醉後大丈夫3
To My Dear Granny	親愛的奶奶
The Double Lover	雙面愛人
Space Brothers	宇宙兄弟
Dare	愛我敢不敢
Ghostbusters	魔鬼剋星
Patema Inverted	帕蒂瑪的顛倒世界
Christmas Rose	聖誕玫瑰
The Wolverine	金鋼狼：武士之戰
All's Well Ends Well 2011	最強囍事
Before I go to sleep	別相信任何人
Miao Miao	渺渺
Chase Our Love	宅男總動員之女神歸來
Black & White Episode 2	痞子英雄2
House Of Wolves	惡人谷
Stars are born	星光傳奇
A Bride for Rip Van Winkle	被遺忘的新娘
Grazing the Sky	絕美極限
Earth to Echo	地球迴聲
Mr. Highheels	高跟鞋先生
Lone Survivor	紅翼行動
Switch	天機：富春山居圖
Mystery Fobber	月色猙獰
Enchanted Mirror Romance	魔鏡奇緣
Ava	那年夏天的微光
The Crocodiles	少年鱷魚幫
Bujilan	布基蘭
The Light	減法人生
Text For You	真愛LINE著你
Julie &amp; Julia	美味關係
Creed	金牌拳手
Escape Room	密弒逃脫
カメレオン	變色龍
Chasing Hemingway	遭遇海明威
Enchanted Doll	怖偶
Wolves	狼人鎮
Umizaru 3: The Last Message	海猿3D
Rish of the Legend	黃飛鴻之英雄有夢
Youth Without Youth	第三朵玫瑰
The Curious Case of Benjamin Button	班傑明的奇幻旅程
Our graduation	我們畢業啦
Zero Dark Thirty	00:30凌晨密令
Xuan Yuan the Great Emperor	軒轅大帝
Oriental Casablanca	澳門往事
Hercules	海克力士
Clash of the Titans	超世紀封神榜
The Bank Job	玩命追緝
Tears of April	四月情塚
Happy Dream	幸福夢想
Bridge to Terabithia	尋找夢奇地
Red 2	超危險特工2：狠戰
Hell Or High Water	赴湯蹈火
Penelope	真愛之吻
Curse of the Demon	詭咒
Distant Thunder	迷城
Harmony	美麗的聲音
Money and Love	恭喜發財之談錢說愛
The Fox & the Child	狐狸與我
The Woman Knight of the Mirror Lake	競雄女俠-秋瑾
Panda Hero Legend	我是大熊貓之熊貓大俠
Tokyo Ghoul	東京喰種
Let's Get Married	咱們結婚吧
A Thousand Words	千字遺言
Lucy	露西
Salut d'Amour	愛的禮讚
The Identical	雙生
The Other Boleyn Girl	美人心機
App	手機有鬼
The Tempest	暴風雨
Beijing New York	北京紐約
Japanese Salaryman NEO	菜鳥薪鮮人
Grown Ups	亞當等大人
District B13: Ultimatum	暴力特區：極限殺陣
Seediq Bale I	賽德克·巴萊(上)：太陽旗
I'm Off Then	我出去一下
Cloudy with a Chance of Meatballs	食破天驚
The Mythical Ark&#160;: Adventure In Love And Happiness	喜羊羊與灰太狼大電影5喜氣羊羊過蛇年
Angel Warriors	鐵血嬌娃
Full Circle	飛越老人院
Deception Obsession	詭影迷情
Love Songs	巴黎小情歌
Xi Jiu	喜酒
Mary & Max	巧克力情緣
The Quiet Ones	靈異檔案
How Do You Know	愛在心裡怎知道
Duckweed	乘風破浪
I Just Didn't Do It	嫌豬手事件簿
Contagion	全境擴散
Frozen River	冰原之心
Meeting Dr. Sun	行動代號：孫中山
Yang Yang	陽陽
Paper Castles	愛同窗愛同床
Brasserie Romantiek	羅曼蒂克大飯店
Video Clip	駭人手機
Martial Spirit	武動青春
10,000 Miles	一萬公里的約定
Little Big Soldier	大兵小將
Senior	聞鬼師
North Point	北角
Behind Bayonets and Barbed Wire	鐵血殘陽
Cuban Fury	騷莎大塊呆
An Eye for Beauty	2夜情
As the Winds Blow	戀戀海灣
Spanish Affair	風流西班牙
Kingsman: The Secret Service	金牌特務
The Code	人體密碼
Young And Beautiful	美麗．誘惑
Yesterday Once More	誰的青春不迷茫
The Amazing Spider-Man	蜘蛛人：驚奇再起
Steve Jobs	史帝夫賈伯斯
Babylon A.D.	巴比倫密碼
Saw VI	奪魂鋸6
Judge Archer	箭士柳白猿
Waiting for Forever	等到永遠
Valentine's Day	情人節快樂
A Chinese Odyssey Part III	大話西遊3
Whatever Lola Wants	玩美舞孃
Mother's Revenge	貓臉老太太
All's Well End's Well 2012	八星抱喜
Poetry	生命之詩
Welcome To The Happy Days	五星級魚乾女
Veronica Mars	偵探小天后
Beyond the Lights	燈光之外
Terra Formars	火星異種
American Ultra	廢柴特務
Definitely, Maybe	愛情三選一
Get Outta Here	死開啲啦
Inside or Outside	真相禁區
ゲゲゲの鬼太郎	鬼太郎
A Singing Fairy	尋找劉三姐
Smosh: The Movie	神馬氏電影版
The Moment	我們的那時此刻
Escape from Planet Earth	地球人壞壞
Adieu Paris	人約巴黎
Red Cliff	赤壁
Love of Shajingcun	沙井村之戀
33 Postcards	美麗謊言
Saying good-bye, oneday	再見總有一天
Bride Wars	新娘大作戰
Untraceable	Live殺人網站
Jian Bing Man	煎餅俠
Lift to Hell	電梯驚魂
Certified Copy	愛情對白
The Ghost Writer	獵殺幽靈寫手
1408	1408
Death Zone	地域無門
Hi Fidelity	出軌的女人
Trainwreck	姐姐愛最大
The Dead End	烈日灼心
The Love Flu	三月情流感
Conspiracy	時下暴力
Gabriel’s Voice	來自天堂的音符
Jack Goes Boating	為愛瘋狂
Knife Fight	選戰風暴
Ruby Sparks	客製化女神
The Romantics	浪漫愛婚頭
Inglourious Basterds	惡棍特工
The New Year's Eve of Old Lee	過年好
Project X	派對X計劃
Tom at the Farm	湯姆在農莊
Never Give Up	不離不棄
Heaven and Hell	監屍器
The Frog Kingdom 2: Sub-Zero Mission	青蛙王國之冰凍大冒險
Rabbit Without Ears 2	沒有耳朵的兔子2
The Fox Lover	白狐
Brotherhood of Blades	繡春刀
Comedy makes you cry	拍賣春天
The Girl Who Kicked the Hornet's Nest	直搗蜂窩的女孩
Tooth Fairy	牙仙大帝
The Book of Revelation	肉體性追緝
This is Life	生門
Freezer	冰人啟示錄
Finding Mr.Right	北京遇上西雅圖
The Babadook	鬼敲門
Secret in Their Eyes	沉默的雙眼
Lost in Wrestling	搏擊奇緣
10,000 MILES	一萬公里的約定
I Love Wolffy	我愛灰太狼
Gangster Rock	混混天團
The Illusionist	魔術師
Summer's Desire	泡沫之夏
Goodbye Mr. Loser	夏洛特煩惱
One Night Stud	有種你愛我
In The Room	無限春光27
Left Behind	末日迷蹤
Avenue Montaigne	巴黎不打烊
Love	愛
Café·Waiting·Love	等一個人咖啡
27 Dresses	27件禮服的祕密
Nights in Rodanthe	羅丹薩的夜晚
Perfect Beyond	完美超越
The Brother	黑暗中的救贖
Carlos	卡洛斯
Up in the wind	等風來
The Mechanic	極速秒殺
Summer Wars	夏日大作戰
The Lost Tomb	盜墓筆記
Black & White:The Dawn of Justice	痞子英雄：黎明再起
Genuine Love	真愛
Nezha<	少女哪吒
Savage Grace	浮華陷阱
Money Makes Trouble	小題大做
The Weird Doll	詭娃
My Sassy Girl 2	我的野蠻女友2
The American	完美狙擊
Geostorm	氣象戰
When Night Falls	我還有話要說
Night at the Museum: Battle of the Smithsonian	博物館驚魂夜2
百萬殺人實驗	百萬殺人實驗
Bait 3D	大海嘯鯊口逃生
Red Cheongsam	恐怖禁忌之紅旗袍
A Complicated Story	一個複雜故事
Farm House 81	81號農場之保衛麥咭
Jade and the Pearl, The	翡翠明珠
S Strom	S風暴
Spring	魔物戀人
The Jungle Book	與森林共舞
Ah Boys to Men	新兵正傳
Blindness	盲流感
Inferno	地獄
Gatao	角頭
Tropic Thunder	開麥拉驚魂
Trespass Against Us	犯罪教條
Bleeding Mountain	凶間雪山
When Larry Met Mary	陸垚知馬俐
Once in a Blue Moon	鬼壓床了沒
War for the Planet of the Apes	猩球崛起3
Rust & Bone	烈愛重生
Attabu	阿罩霧風雲
Mr. Holmes	福爾摩斯先生
Only Lovers Left Alive	噬血戀人
Finishing the Game	非關英雄
Rest on Your Shoulder	肩上蝶
Block Buster	大片
Happiness Is Very Embarrassing	幸福很囧
Marley &amp; Me	馬利與我
Water for Elephants	大象的眼淚
The Bride	屍憶
Detective Dee and the Mystery of the Phantom Flame	狄仁傑之通天帝國
Fall In Love	愛神
Devil's Due	惡靈嬰弒
Let's Fall In Love	我們戀愛吧
The Murderer Vanishes	消失的兇手
Insidious: Chapter 3	陰兒房第3章：從靈開始
My Little Pony: The Movie	彩虹小馬大電影
Straw Dogs	稻草狗
Next Station I Love You	下一站再愛你
Tomorrow when the war began	破曉開戰
Ricky and the Flash	搖滾女王
Mother!	母親!
The Warriors Gate	勇士之門
Mr. Zhai	宅男總動員：女神歸來
White Elephant	白象:無法之城
Before the Devil Knows You're Dead	魔鬼知道你死前
Lilting	輕輕搖晃
The Founding of a Party	建黨偉業
Logan Lucky	羅根好好運
Running All The Way	一路狂奔
Red Eagle	紅鷹俠
Life During Wartime	心靈戰火
Marmaduke	酷狗馬馬杜
Danny Collins	翻唱人生
The Nut Job	堅果行動
南風（なんぷう）	南風
Alvin and the Chipmunks: The Road Chip	鼠來寶：鼠喉大作讚
The Soccer Way	聖龍奇兵大冒險
Nerve	玩命直播
Barney's Version	巴尼正傳
War on a String	懸戰
Love Me No	不能愛
Fearless	熱血街頭
The Last Race	終極勝利
Prom	高校舞會
Make Me Shudder 2	這個高中沒有鬼2
Suck Me Shakespeer	不良鮮師
First Time	第一次
Warrior VS Dragon	我叫MT之山口山戰記
The Hobbit: The Desolation of Smaug	哈比人：荒谷惡龍
Baby Steps	滿月酒
Golden Chickens	金雞SSS
Bitter Love	哭戀
4B Qing Nian Zhi 4 Lou B Zuo	4B青年之4樓B座
xXx: The Return of Xander Cage	限制級戰警3
An Irasclble Angel	暴躁天使
ぼくたちと駐在さんの700日戦争	我和條子的700天戰爭
Jessabelle	母難日
The Invisible Guest	佈局
Souvenir	伴手禮
Fit Lover	愛情左右
The Verse of Us	我的詩篇
Paranoia	決勝機密
Chinese Zodiac	十二生肖
Ant-Man	蟻人
Meet The In Laws	搞定岳父大人
There Will Be Blood	黑金企業
Frances Ha	紐約哈哈哈
Elephant Song	憂傷大象之歌
Wet Woman in the Wind	野風溼身的女人
Machete Kills	殺千刀重出江湖
カイジ ∼人生逆転ゲーム∼	賭博默示錄
Gravity	地心引力
The Boy Next Door	隔壁的男孩殺過來
The Treacherous	姦臣:色誘天下
Oz the Great and Powerful	奧茲大帝
Zoom Hunting	獵豔
Doraemon The Movie 30th	大雄的人魚大海戰
Ex Machina	機械姬
Time to Love	新步步驚心
The Night Before	聖誕前夜
No Escape	無處可逃
Tears	眼淚
Thor: Ragnarok	雷神索爾3
The Villainess	惡女
The Visitor	幸福來訪時
Krampus	聖誕妖怪：坎卜斯
Collateral Beauty	最美的安排
Young at Heart: Grandma Cheerleaders	青春啦啦隊
Ghost Mother	守護靈
My Mom's New Boyfriend	我媽的新男友
David Loman	大尾鱸鰻
Red Lights	第7度感應
Seer	賽爾號之尋找鳳凰神獸
The Hobbit: The Battle of the Five Armies	哈比人：五軍之戰
The BFG	吹夢巨人
Crying Out In Love	在世界中心呼喚愛
Ending Note	多桑的待辦事項
Nankou in 1937	南口1937
Love & Friendship	蘇珊夫人尋婚計
The Tempests of First Love	初戀風暴
God's Not Dead	上帝未死
OPEN！ OPEN！	OPEN！ OPEN！
Inina Ptnaq Na Bcingan	不一樣的月光
Colonia	窒命地
Words and Pictures	字畫情緣
Lion Dancing 2	鐵獅玉玲瓏2
Horse Trader	盜馬記
Dating Fever	我為相親狂
[REC] 3: Genesis	錄到鬼3
Guns N'Roses	黃金大劫案
Heaven In The Dark	暗色天堂
Gangster Pay Day	大茶飯
The Map of DNA	他媽²的藏寶圖
Love You 10000	愛你一萬年
Legend of Sudsakorn	聖麒麟傳說
Confessions of a Shopaholic	購物狂的異想世界
Dragon Blade	天將雄師
Solanin	手拉你
52Hz, I love you	52赫茲,我愛你
Don’t go breaking my heart	單身男女
The SpongeBob Movie: Sponge Out of Water	海綿寶寶：海陸大出擊
Amour Legende	松鼠自殺事件
What Love May Bring	情海浮生錄
I.O.U.S.A.	巴菲特報告
Marriage With A Liar	婚前試愛
Shrek Forever After	史瑞克快樂4神仙
The Adventures of Tintin: The Secret of the Unicorn	丁丁歷險記：獨角獸號的秘密
The Village Of No Return	健忘村
The Past	咎愛
Tron: Legacy	創：光速戰記
The Beguiled	魅惑
Kung Fu Chefs	功夫廚神
Paranoid Park	迷幻公園
The Twilight Saga: New Moon	暮光之城2
Villain	惡人
Suite Francaise	亂世有情天
Happy Adventure	開心大冒險
Yi Bu Liu Shen	一不留神
Jobs	賈伯斯
Royal Treasure	極限挑戰之皇家寶藏
Strike Out	三振
The Golden Child	內人／外人－金孫
Unforgettable Blast	迷與狂
What Happened To Monday	獵殺星期一
The Collection	蒐屍魔
I'm Here For You	為你而來
Forever Love	阿嬤的夢中情人
Lethal Hostage	邊境風雲
Ready Player One	一級玩家
Where Are All The Time	時間都去哪了
Salt	特務間諜
Irrational Man	愛情失控點
Concussion	震盪效應
Speed Racer	駭速快手
Resident Evil: Afterlife	惡靈古堡4：陰陽界
Museum	惡魔蛙男
The Predictor Paul	章魚哥
StreetDance 3D	3D舞力對決
The Nutcracker in 3D	魔境冒險3D
Fijil Love	斐濟99℃愛情
Regression	邪靈刑事錄
Pathology	恐怖解剖室
Big Eyes	大眼睛
Love In Cosmo	搖擺de婚約
Beauty and the Beast (3D)	美女與野獸3D
The Love Guru	愛情大師
The Sorcerer and the White Snake	法海:白蛇傳說
To Rome with Love	愛上羅馬
Finding Vivian Maier	尋秘街拍客
Laugh and Cry Forbidden	哭笑不得
L.O.R.D: Legend of Ravaging Dynasties	爵跡
Hercules 3D	鋼鐵力士
Honnouji Hotel	本能寺大飯店
The Snowman	雪人
Rabbit Horror 3D	怨靈
Grace is Gone	等媽媽回家的孩子
Neko Atsume House	貓咪收集之家
Most Dangerous Man, The	最·黑色追緝令
Midnight Meat Train	午夜人肉列車
Welcome To Yesterday	跨界失控
Mid-July Days	七月半之恐怖宿舍
Love And Hate From Cyber	誰偷了我的菜
Snow White: The Mysterious Father	白雪公主之神秘爸爸
Who Killed Cock Robin	目擊者
American Pastoral	美國心風暴
Alvin and the Chipmunks: The Squeakuel	鼠來寶2
殭屍哪有那麼帥?	殭屍哪有這麼帥?
Leap Year	敗犬求婚日
Provoking Laughter	冒牌臥底
Love Will Be Back	等愛歸來
GF。BF	女朋友。男朋友
The Green Prince	哈瑪斯之子
Psychic	通靈之六世古宅
Declaration of War	親愛的別哭
One Piece Movie 3D Mugiwara Chase	航海王3D
1987: When The Day Comes	1987：黎明到來的那一天
Lost On Journey	人在囧途
Attack On Titan	進擊的巨人
Mom, Let Me Love You Once Again	媽媽，讓我再愛你一次
Gnomeo and Juliet	糯米歐與茱麗葉
Bread of Happiness	幸福的麵包
Nocturnal Animals	夜行動物
Welcome to Me	歡迎來到我的世界
Eternal Promise of Love	天各一方
The Longest Ride	愛情沒有終點
Rock of Ages	搖滾時代
Double Exposure	詭替身
Step Up: All In	舞力全開5 3D
Pet	寵物情劫
Prince	哥基王子
Adiantum Blue	鐵線蕨的憂鬱
Man of Steel	超人：鋼鐵英雄
The Unbearable Lightness of Inspector Fan	暴走神探
Planes	飛機總動員
Amphetamine	安非他命
Mr. Peabody & Sherman	皮巴弟先生與薛曼的時光冒險
Kung Fu Panda 2	功夫熊貓2
That Year School Ended	畢業那年
A Dangerous Method	危險療程
Roco Kingdom 4	洛克王國4：出發！巨人谷
Henry Poole is Here	上帝在我家
Self Redemption	自我救贖
Sorry I Want to Marry You	愛妳衝婚頭
Dear Enemy	親密敵人
Zombie Fight Club	屍城
Pigeon Tango	盜命師
Crimes of Passion	一場風花雪月的事
Looper	迴路殺手
Cars 2	汽車總動員2：世界大賽
The Adventures of Sinbad 2014	辛巴達歷險記2
Rush	決戰終點線
Somewhere Connected	那美
Dead Awake	夢魔纏身
Neighborhood Watch	巡邏驚很大
Girls Generation	半熟少女
Forever Love Grandma	阿嬤的夢中情人
Black & White Episode I	痞子英雄之全面開戰
Before We Go	紐約愛未眠
The D Train	糟糕的兄弟情
Brideshead Revisited	慾望莊園
An Urgent Letter	鏢行天下前傳之四百里加急
Closed Circuit	全面鎖定
Sifu VS Vampire	天師鬥殭屍
Paris	巴黎愛情故事
No Money no Talk	十萬伙急
The Action Zero	變身超人
Storm Rider : Clash of Evils	風雲決
Crimson Peak	腥紅山莊
Australia	澳大利亞
Let Panda Fly	讓熊貓飛
Son of Saul	索爾之子
Elena	愛琳娜
Mind Decoding	心靈解碼
Secret Plans	新大頭兒子和小頭爸爸之秘密計劃
Smallfoot	小腳怪
Vanishing On 7th Street	消失在第七街
Cold War II	寒戰2
The Horsemen	天啟四騎士
The White-haired Girl	白毛女
Salt of this Sea	淚海
Jungle	逃出亞馬遜
MicroSex Office	潮性辦公室
Overheard	竊聽風雲
PoorRich Dad	貧窮富爸爸
The Chronicles of Narnia: The Voyage of the Dawn Treader	納尼亞傳奇：黎明行者號
Predators	終極戰士團
Were the World Mine	世界屬於我們
My Week with Marilyn	夢露與我的浪漫週記
G.I. Joe 2: Retaliation	特種部隊2
Mortdecai	神鬼大盜
One Week Friends	一週的朋友
Underworld Awakening	決戰異世界：未來復甦
Young Friend Forever	我的青春蜜友
Hotel Transylvania 3	尖叫旅社3
The Avengers	復仇者聯盟
Lei Feng in 1959	雷鋒在1959
Kung Fu Pop 2	精舞門2
Chef's Special	基佬大廚
Sweet Summer Love	夏日示愛
Do You See Me?	我的型男老闆
The Whisper	魔都凶音
Jack Ryan: Shadow Recruit	傑克萊恩︰詭影任務
Tales from the Dark	鬼夜
クレヨンしんちゃん　超時空！嵐を呼ぶオラの花嫁	蠟筆小新
Red Amnesia	闖入者
The Frog Ville	桃蛙源記
Detachment	人間師格
Pubescence 3	青春期3
The Purge	國定殺戮日
Super Kindergarten	超級幼兒園
Neighbors	惡鄰纏身
Hot Tub Time Machine 2	扭轉時光機2
Beverly Hills Chihuahua	比佛利拜金狗
Grown Ups 2	亞當等大人2
An Accidental Shot or Love	擦槍走火
Ace Attorney	逆轉裁判
Tekken: Blood Vengeance	鐵拳:血之復仇
Cherish in Love	愛你不等來生
SP 野望篇	型男特警:野望篇
Shark Night 3D	大白鯊3D
Hellboy 2	地獄怪客2
Cha cha for Twins	寶米恰恰
You and Me	我和你
The Unfortunate Car	車在囧途
Birdman	鳥人
Roaring Currents	鳴梁:怒海交鋒
Crows - Episode 0	漂丿男子漢
Call of Heros	危城
The Other Guys	B咖戰警
Touch of the Light	逆光飛翔
Tomorrow at Dawn	明天的黎明
クロサギ	詐欺獵人
クローズＺＥＲＯ II	漂丿男子漢2
Di Yi Shu Ji	第一書記
Beasts of No Nation	無境之獸
The Bubble	泡泡公寓四人行
Cape No.7	海角七號
The Ideal City	一座城池
Dalida	絕代天后黛莉達
The Summer of Our Graduation	我們畢業的夏天
Trail of the Panda	貓熊團圓路
The Rice Bomber	白米炸彈客
The Cold Light of Day	冷光線索
Diary of a Wimpy Kid: Dog Days	遜咖冒險王3
The Eyes Diary	彎道鬼情人
Strawberry Cliff	贖命
The Struggling Ants	狂奔螞蟻
Star Wars: Episode I The Phantom Menace 3D	星際大戰:威脅潛伏3D
Who Moved My Dream	誰動了我的夢想
An Inaccurate Memoir	匹夫
Nun Chucks	雙截棍
Money Not Enough 2	錢不夠用2
Back to 1942	一九四二
Skiptrace	絕地逃亡
Need for Speed	極速快感
Lotus Code	諜·蓮花
Underworld 5	決戰異世界5
Paul the Octopus	追蹤章魚保羅
Silent Hill: Revelation 3D	沉默之丘2：啟示錄
De-Single Bible	脫單寶典
Hector and the search for happiness	尋找快樂的15種方法
Overheard 2	竊聽風雲2
Sex and the City: The Movie	慾望城市電影版
The Bélier Family	貝禮一家
Mo Deng Sen Lin Zhi Mei Shi Zong Dong Yuan	摩登森林之美食總動員
Lesson Of The Evil	惡之教典
My Super Girl	我的女神女漢子
For Love	致我們終將到來的愛情
In the House	登堂入室
Eastern Promises	黑幕謎情
Finding Nemo 3D	海底總動員3D
Help Me Eros	幫幫我愛神
Sorry, Baby	寶貝，對不起
100 Days	真愛100天
The Galaxy On Earth	天河
Tales of Halloween	萬聖夜怪譚
Things to Come	愛情未來
Seer III	賽爾號大電影3之戰神聯盟
Rock On!	實習大明星
Flower's Curse	花咒
Furry Vengeance	野蠻大對決
Love Studio	同城邂逅
The Lucky One	幸運符
The Maid	女僕
Elegy	禁慾
Our Family Wedding	我的家庭婚禮
My Love	愛你的人
The Hunger Games: Mockingjay - Part 1	飢餓遊戲3
Broadcasting Girl	我的播音系女友
Robot Overlords	鋼鐵叛軍
The 15:17 to Paris	15:17巴黎列車
Goodbye May	走出五月
So Young	致我們終將逝去的青春
Night Blooming	隔窗有眼
Funny Games	大劊人心
Wild Tales	生命中最抓狂的小事
The flowers blooming	山花爛漫時
Now Is Good	愛正好
Ghost Hospital	幽靈醫院
The Fifth Element	第五元素
Lakeview Terrace	合法入侵
The Bride With Painted Skin	聊齋新編之畫皮新娘
Long Long Time Ago 2	我們的故事2
Sentence Me Guilty	判我有罪
I Love You, Mom	媽媽，我愛您
The Secert of Loch Ness	尼斯湖水怪傳說
Amy	艾美懷絲
Close to you	近在咫尺
The Croods	古魯家族
名探偵コナン　天空の難破船	名偵探柯南14
Cover boy	男色多瑙河
Mother of Tears	木乃伊博物館
Mysterious Island 2	孤島驚魂2
Thor: The Dark World	雷神索爾2：黑暗世界
Rampart	野獸特警
The End of the Tour	寂寞公路
Super Player	大玩家
A Departure from Love	與愛別離
Olympus Has Fallen	全面攻佔：倒數救援
A Few Hours of Spring	春日光景
The Taking of Pelham 1 2 3	亡命快劫
Southpaw	震撼擂台
The Chef The Actor The Scoundrel	廚子戲子痞子
Notte prima degli esami - Oggi	2008新畢業生
My Belle Boss	我的美女老闆
Dead Sign	古鎮凶靈之巫咒纏身
The Second Coming	重生
Love Deposit	愛情銀行
Dream Come Ture	一刻十年
Spicy hot in love	愛情麻辣燙之情定終身
Mother's Dream	母親的夢想
Glee The 3D Concert Movie	歡樂合唱團
The Ten	愛情十賤事
Shock Wave	拆彈專家
Nanny's Love	乳娘情
Tempest of First Love	初戀風暴
Bolt	雷霆戰狗
One wrong step	無底洞
Sanctum	3D驚天洞地
The Preppie Connection	玩酷壞痞子
A Wishing Tree	一棵心中的許願樹
Submarino	傷心潛水艇
Step Up 4	舞力全開4
Deng Ni Zhui Wo	等你追我
The Transporter Legacy	玩命快遞4
Turtle: The Incredible Journey	在海裡飛翔
Young and Dangerous: Reloaded	古惑仔：江湖新秩序
Madagascar: Escape 2 Africa	馬達加斯加2
Before Midnight	愛在午夜希臘時
Lost and Lonely	失孤
Third Person	情慾三重奏
This Summer Feeling	夏日情事
The Forger	驚世劫作
Caught in trap	破局
Exte: Hair Extensions	美髮屍
Vincent and the end of the world	少年文森的瘋狂世界
The Two Faces of January	蜜月殺機
The Chronicles of Narnia:	納尼亞傳奇3
The Venice Syndrome	威尼斯我愛你
Butterfly on a Wheel	贖命24小時
Hunting and Gathering	巴黎夜未眠
Qing Di Zhi Ai	情笛之愛
Rise of the Legend	黃飛鴻之英雄有夢
Point Break	飆風特攻
Avengers: Infinity War	復仇者聯盟3
From Prada to Nada	小姐好窮
Phurbu & Tenzin	西藏天空
Killing Them Softly	殺戮行動
The Assassination of Jesse James by the Coward Robert Ford	刺殺傑西
Ballet in the Flames of War	戰火中的芭蕾
Qu Li Qiang	渠立強
Black Swan	黑天鵝
Who moved My Fiancee	海島之戀
John Carter	異星戰場：強卡特戰記
All About Love	得閒炒飯
The Assassin	刺客聶隱娘
Parker	偷天派克
How to Be Single	單身啪啪啪
Flashbacks of a Fool	舊愛，還是最美
Marrying Mr. Perfect	嫁個100分男人
Bug	恐怖幻象
Legend of Didao	小西天狄道傳奇
Delicacy	愛情好意外
Superhero Movie	又一部超人電影
Holy Motors	花都魅影
Rango	飆風雷哥
Deadpool 2	死侍2
Rise of the Apes	猩球崛起
Change A Life-style	換個活法
Two Thumbs Up	衝鋒車
Fallen City	傾城
Resident Evil: The Final Chapter	惡靈古堡6
Bicycle Boy	龍騎俠
What to Expect When You're Expecting	好孕一起來
The Thing	極地詭變
U2 3D	U2:3D立體演唱會
Curious Case of Benjamin Button	班傑明的奇幻旅程
My Mandala	原來你還在
Nine Lives	我的老爸喵星人
Drink Drank Drunk	3條友飲醉走
Force Majeure	婚姻風暴
My War	我的戰爭
The Ape Story	猿創世界之熊孩子部落
Step by Step	練戀舞
The Dressmaker	惡女訂製服
Love you forever	愛·你別走
The Mermaid	美人魚
The Great Match	決戰日
Journey 3-D	3D地心冒險
Our Idiot Brother	我的傻老哥
Punished	報應
Waltz with Bashir	與巴席爾跳華爾滋
Wo Shi Xiang Xia Ye	我是鄉下爺
Legend Of The Moles-The Frozen Horror	摩爾莊園冰世紀
Dear John	最後一封情書
The Sacrament	生人活祭
Gf & Bf	女朋友。男朋友
Inhumans	異人族
I am Director	瘋狂的導演
10 Cloverfield Lane	科洛弗10號地窖
Ned Rifle	追殺大笨蛋
My Ex 2: Haunted Lover	鬼陰驚
My Kingdom	大武生
The Water Horse: Legend of the Deep	尼斯湖水怪
The Equalizer	私刑教育
The Perfect Match	終極匹配
The Pirates	海賊：汪洋爭霸
Evergreen Love	植物圖鑑
About Ray	幸福不設限
The Heat	麻辣嬌鋒
Days of Our Own	我們的十年
Lockout	天外封鎖線
Sicario 2: Soldado	怒火邊界2
Fifty Shades Freed	格雷的五十道陰影3
The Bird Who Saved the World	什麼鳥日子
Ending Cut	老徐的完結篇
Never Let Me Go	別讓我走
Fall in Love	愛上處女座
Mechanic: Resurrection	極速秒殺2
Pale Moon	紙之月
The Broken Circle Breakdown	愛的餘燼
Go away Mr. Tumour	滾蛋吧！Mr. Tumor
Deliver Us from Evil	惡魔刑事錄
Let the Bullets Fly	讓子彈飛
Happy Death Day	忌日快樂
The Journey	一路有你
Taipei Factory	台北工廠
At Any Price	玩命代價
The Diving Bell and the Butterfly	潛水鐘與蝴蝶
Stephen King's The Mist	迷霧驚魂
La Danse: The Paris Opera Ballet	舞動芭黎,掌聲蕾動
Tales from Earthsea	地海戰記
A Time of Beauty	時尚女郎之女人江湖
Three Idiots	三個孬傢伙
Let the Right One In	血色入侵
Trekking The Way Home	縱行囝仔
The Witness	我是證人
Song One	紐約安可曲
Top Five	喜劇人生
The Last Tycoon	大上海
The Midas Touch	超級經理人
Labyrinth Of Lies	謊言迷宮
This Is Where I Leave You	愛在頭七天
The Puzzle of Human Skin	人皮拼圖
Bu Bu Zhui Hun	步步追魂
Coursier	終極快遞
Boy A	心靈鐵窗
Red Road	紅路
Exit	迴光奏鳴曲
Long Weekend	陰巢
The Passionate Life of Edith Piaf	玫瑰人生
Ripples of Desire	花漾
Younger Brother	春之櫻
Seeking a Friend for the End of the World	末日情緣
The Incite Mill	七日死亡遊戲
Confessions	告白
Cairo Time	開羅時間
Only God Forgives	罪無可赦
Winnie the Pooh	小熊維尼電影版
Lost in Island	島囧
When Geek Meets Serial Killer	宅男女神殺人狂
Utopians	同流合烏
Xi Bai Po: Wang Er Xiao	西柏坡2：王二小
Shaun the Sheep Movie	笑笑羊大電影
Buppha Revenge	609猛鬼終結者
Before I Disappear	在我消失之前
N＋N	N＋N
Ways to Live Forever	永遠在一起
Pride and Prejudice and Zombies	傲慢與偏見與殭屍
Caught in the Web	搜索
Saw IV	奪魂鋸4
The Curse of Chopsticks	筷仙
Din Tao：Leader of the Parade	陣頭
Liza, the Fox-Fairy	狐仙麗莎煞煞煞
Sword Art Online the Movie: Ordinal Scale	刀劍神域劇場版－序列爭戰
Baby Bumps	辣媽好孕到
Train of the Dead	猛鬼列車
Drive	落日車神
Shaolin Girl	少林少女
The Assassins	銅雀台
Wild City	迷城
Resident Evil: Vendetta	惡靈古堡:血仇
The Futute X-Cops	未來警察
Doomed Disaster	詭劫
Three Kingdoms: Resurrection of the Dragon	三國之見龍卸甲
Bends	過界
Man on Wire	偷天鋼索人
Coco Chanel &amp; Igor Stravinsky	香奈兒的秘密
Piranha 3DD	3D食人魚2：全面獵殺
Furious 8	玩命關頭8
Murcielago	蝙蝠別墅
Shrew’s Nest	凌刑密密縫
Demon 2	毒禍2
Tales of Mystery	怪談
Megamind	麥克邁：超能壞蛋
Westgate Tango	西門町
Tusk	人型海象
The Hottie & the Nottie	愛上野豬妹
Bucky Larson: Born to Be a Star	天生萬人迷
Summer times	夏天協奏曲
Badges Of Fury	不二神探
Look Who's Back	吸特樂回來了！
Stilt	候鳥的季節
A Hologram for the King	梭哈人生
The Magical Brush	神筆馬良
Nightwatching	夜巡林布蘭
One Night Surprise	一夜驚喜
Paranormal Activity	靈動:鬼影實錄
A Bite of China: Celebrating the Chinese New Year	舌尖上的新年
The Cobbler	命運鞋奏曲
Some Like It Hot	情聖
The Other Side of the Door	鬼門開
Amalfi: Rewards of the Goddess	女神的報酬
Cold War 2	寒戰
A Haunted House	鬼屋電影
The Attorney	正義辯護人
War Horse	戰馬
Due Date	臨門湊一腳
Arthur	阿舍正傳
Kaboom	入侵潛意識：迷幻異域
Molly's Game	決勝女王
Hollars	重返心原點
A Madea Christmas	黑瘋婆娘的聖誕節
Break Up Club	分手說愛你
A Million Ways to Die in the West	百萬種硬的方式
Guilty	四非
Vampire Cleanup Department	救殭清道夫
2:20	2分20秒
Choy Lee Fut	蔡李佛
Life Back Then	彼時生命
自虐の詩	自虐之詩
Gui Yan	詭魘
The King Of Comedy	喜劇王
Scandals	囧人之越撓越癢
Jack the Giant Slayer	傑克：巨人戰紀
The Deadly Strands	咒絲
The Lincoln Lawyer	下流正義
Special Forces	沙漠神兵
I Love That Crazy Little Thing	那件瘋狂的小事叫愛情
To Forgive	查無此人
The Hunt	謊言的烙印
Don Jon	超急情聖
MacGruber	百戰天龍馬蓋鮮
Taipei Factory 2	台北工廠II
Fruity Robo The Great Escape	果寶特攻之水果第三集中營
Cairo Declaration	開羅宣言
Entourage	2015 大明星小跟班
Ameera	特工艾米拉
Forbidden Kiss	古堡之吻
Ashes To Ashes	從哪來，到哪去
Target Locked	目標戰
Born to Love You	大叔，我愛你
Dao Ban Ai Qing	盜版愛情
The Man Behind the Courtyard House	守護者：罪惡迷途
Special Treatment	特別服務
Sex & Chopsticks 2	金瓶梅2
The Double	盜貼人生
Secret Sharer	海上情謎
The Commuter	疾速救援
Delivery Man	百萬精先生
We Will Make It Right	因為谷桂花
Jumper	移動世界
Keep Running! Sir, Yes Sir!	誰說軍中沒有鬼
The Sentiment of the Flesh	情慾內視鏡
Death Race	絕命尬車
Snow White	名模神采
Undertow	暗擁
Big Blue Lake	大藍湖
The Measure of a Man	衡量一個人
Chinese Wine	國酒
The Tower	火海108
The Big Lie Bang	謊言大爆炸
Our Daily Bread	沉默的食物
XXY	我是女生，也是男生
Beauty and the Beast 3D	美女與野獸3D
Brooklyn's Finest	惡夜特警隊
Monsterz	超能對決
Black Book	黑書
Diva	DIVA華麗之後
The Maze Runner: The Scorch Trials	移動迷宮2
Spread	情聖終結者
The Crazies	屍心瘋
The Pirates! Band of Misfits	海賊天團
72 Hours of Sword Robbing	盜劍72小時
Let Go For Love	放手愛
The Police Diary	警察日記
Haywire	即刻反擊
Z Storm	Z風暴
Sorry if I love you	熟男我愛你
Coco Chanel & Igor Stravinsky	香奈兒的秘密
Someone You Love	最靠近心的距離
The Man from U.N.C.L.E.	紳士密令
Cinderella	仙履奇緣
Letters to Juliet	給茱麗葉的信
12 Golden Ducks	12金鴨
Once Upon A Time In Shanghai	惡戰
Manchester by the Sea	海邊的曼徹斯特
The Great Beauty	絕美之城
Drive Angry	3D怒火狂飆
Sad Fairy Tale	傷心童話
Crazy, Stupid, Love	熟男型不型
Men in Black III	MIB星際戰警3
The Dark Knight	黑暗騎士
Bully	施壓者
Fire Storm	風暴
Jeet Kung Do	截拳道
Taichi Hero	太極2:英雄崛起
Transformers: Age of Extinction	變形金剛4：絕跡重生
Lucky STAR 2015	吉星高照2015
The Lego Ninjago Movie	樂高炫風忍者電影
Iron Man	鋼鐵人
The King	金權性內幕
Battle Of Hip Hopera	終極舞班
Monster Hunt	捉妖記
A River Runs Through It	大河戀
Hours	搏命關頭
Where to Invade Next	插旗攻城市
Welcome to Germany	歡迎來住我家
American Dreams in China	海闊天空
Call Of Heroes	危城
Troubled Water	心靈暗湧
A Gold Medal Winning Tramp Dog	金牌流浪狗
Black Mirror	少女靈異日記
Forgetting to know you	忘了去懂你
Bunny Drop	白兔玩偶
Rise of the Planet of the Apes	猩球崛起
The Burning Plain	燃燒的原野
Jumping the Broom	婚禮
Hip-hop Storm	街舞
War Dance	烏干達天空下
Deep In The Clouds	碧羅雪山
Victor Frankenstein	怪物
Partners in Crime	共犯
The Ledge	窗台危機
It's Kind of a Funny Story	說來有點可笑
Prom Night	舞夜驚魂
The Wild Strawberries	野草莓
Tiny Times 2.0	小時代：青木時代
Skyline	天際浩劫
Somewhere I Have never Travelled	帶我去遠方
Police Story 2013	警察故事2013
The Monkey King 2	西遊記之孫悟空三打白骨精
Barbara	為愛出走
A Woman in the Shadow	夜魔人
Revolutionary Road	真愛旅程
In the Valley of Elah	震撼效應
Did You Hear About the Morgans?	名牌冤家
Twice Born	摯愛永恆
Knock Knock	當辣妹來敲門
Full Treatment	愛神來了怎知道
Insomnia Lover	失眠男女
The Falling Feather	飄落的羽毛
Persecuted	迫害
Hannibal Rising	人魔
My Sister, My Love	妹妹戀人
Sadako vs Kayako	貞子 VS 伽椰子
Space Panda	太空熊貓歷險記
A Touch of Sin	天註定
Unbroken	永不屈服
Invictus	打不倒的勇者
Anger	怒
Night at the Museum 3	博物館驚魂夜3
Drifting Flowers	漂浪青春
Sweet Sixteen	夏有喬木，雅望天堂
Dunkirk	敦克爾克大行動
By the Sea	海邊
Norbit	糯米正傳
Ice Poison	冰毒
Get on Up	激樂人心
But Always	一生一世
The Happy Kids Adventure	囧蛋奇兵
Amazing	神奇
Polar Adventure	極地大反攻
Chang Chen Ghost Storie	張震講故事之鬼迷心竅
ifva greenlab 2010-2011	委約計劃
イキガミ	死亡預告
Measuring the world	丈量世界
The Incredible Burt Wonderstone	王牌魔術師
Genius	天才柏金斯
The Water Diviner	伊斯坦堡救援
Morengen Bear vs Man	莫日根
Hear Me	聽說
See You I See Me!	看見我和你
The Bad Batch	生存者
Prisoners	私法爭鋒
Unidentified	來歷不明
Carnage	今晚誰當家
Get Out	逃出絕命鎮
The Void	恐懼虛空
The Legend is Born - Ip Man	葉問前傳
創造宇宙壽司男	創造宇宙壽司男
The Secret	控制
ROOKIES -卒業-	菜鳥總動員電影版
Wawa No Cidal	太陽的孩子
Final battle in Chengzigou of kongfu saga	武僧傳奇之決戰程子溝
Fairy Tales	都市童話
Gone Girl	控制
Grudge Match	進擊的大佬
The Detective 2	B+偵探
The Woman in Black: Angel of Death	顫慄黑影2：死亡天使
Comedy Makes You Cry	拍賣春天
Incarnate	卡內陰
She’s funny that way	百老匯風流記
Foret Debussy	德布西森林
The Corpse of Anna Fritz	停屍姦
Another Woman	234說愛你
PK	來自星星的傻瓜
We are What we are	屍房宴
Kick-Ass	特攻聯盟
Dragon Nest: Warriors' Dawn	龍之谷：破曉奇兵
ROOKIES	菜鳥總動員電影版
Eat Pray Love	享受吧！一個人的旅行
Winds of September	九降風
Cai Jin	孝女彩金
The Sky Crawlers	空中殺手
Green Lover	低碳愛情
Old Boy：The Way of The Dragan	老男孩猛龍過江
He-Man	硬漢2奉陪到底
Warm Bodies	殭屍哪有這麼帥
Paris 36	放牛班快樂頌
安娜卡列妮娜	安娜卡列尼娜
Le Grand Chef	食客
Transformers: Dark of the Moon	變形金剛3
Love O2O	微微一笑很傾城
Limi Girl	俐侎阿朵
(Wolf Warriors	戰狼
Hide and Seek	非常父子檔
Allied	同盟鶼鰈
Run	絕錄求生
This is not what I expected	喜歡你
Where Are We Going, Dad? 2)	爸爸去哪兒2
The Postman's White Nights	郵差的白色夜晚
Dream Ocean	夢想海洋
Under The Hawthorn Tree	山楂樹之戀
Aloha	飛越情海
Boonie Bears III	熊出沒之熊心歸來
Monk Comes Down the Mountain	道士下山
Big Bowl of Beijing Tea	大碗茶
My One and Only	只愛多金男
The Death Game	死亡遊戲
Won't Back Down	永不放棄
MIN & MAX	最萌身高差
The Love Songs of Tiedan	美姐
名探偵コナン漆黒の追跡者	名偵探柯南13
Child’s Pose	愛的佔有慾
College Road Trip	大學生了沒
The Ides of March	選戰風雲
A Story About Banana	我不窮，我只是沒有錢
The Piano in a Factory	鋼的琴
The Dark Is Rising	黑紀元
Conan the Barbarian	王者之劍3D
Kung Fu Jungle	一個人的武林
King Of Mahjong	麻雀王
The Wedding Diary	結婚那件事
Rogue	凶鱷
The Island	絕命島
Mayday NOWHERE 3D	五月天諾亞方舟
The Warrior's Way	黃沙劍影
Meet the Spartans	這不是斯巴達
Pirates of the Caribbean: At Worlds End	神鬼奇航3
Harry Potter and the Order of the Phoenix	哈利波特6
The Sniper	神鎗手
JUST TRY ME	關於愛情和那些魔鬼
Gallenets	打擂台
The Break-up Season	畢業那年：分手季
Skate or Die	絕命快閃
I'll See You in My Dreams	我們夢中見
Exeter	鬼附身
All About Puberty	純純欲動
Girl of the Big House	寶貝當家
Painted Skin：The Resurrection	轉生術
Crutch	拐杖
My Wife's A Cat	我的老婆是只貓
Soul Surfer	靈魂衝浪人
The Duchess	浮華一世情
Power Rangers	金剛戰士
One Night Only	天亮之前
Xenia	我的希臘甜心
Sherlock Holmes 2	福爾摩斯2
Franklyn	永恆之門
Graduation	畢業風暴
Silent Code	BBS鄉民的正義
City Monkey	玩酷青春
Men Suddenly In Love	猛男滾死隊
Tomb Mystery	墓穴迷城
Banlieue 13: Ultimatum	暴力特區2
Will You Still Love Me Tomorrow？	明天記得愛上我
MICHAEL H. Prefession : Director	漢內克的導演秘密
Tricks	追火車日記
Bus 657	關鍵救援:巴士657
The Seventh Lie	第7謊言
Swung	春色蕩漾
In This Corner of the World	謝謝你,在世界的角落找到我
Scary Movie 5	驚聲尖笑5
The Intern	高年級實習生
The Eternal Zero	永遠的0
Swinger	愛愛大風吹
Inside the Girls	女生宿舍
Macau 1949	澳門1949
The Twilight Saga: Breaking Dawn - Part 2	暮光之城4:破曉Ⅱ
Bloody Doll	怨靈人偶
Nanimono	何者
Wonder Mama	媽咪俠
10+10	10+10
Larry Crowne	愛情速可達
Good Kill	巡弋狙擊手
Happy Feet Two	快樂腳2
I Have to Buy New Shoes	巴黎鞋奏曲
Any Other Side	夜店詭談
Mark Felt: The Man Who Brought Down the White House	推倒白宮的男人
Nine	華麗年代
Daddy's Home	家有兩個爸
The Back-Up Plan	備胎女王
Love in The Buff	春嬌與志明
Flying with you	一起飛
Unfinished Business	凸槌三人行
From Beginning to End	兄弟情人
The Last Mistress	情慾二重奏
Coming Home	歸來
Welcome to Happy Days	五星級魚干女
Let Me In	噬血童話
Baby Driver	玩命再劫
TOKYO !	東京狂想曲
The Three Pigs and The Lamp	三隻小豬與神燈
Gattu	風箏孩子王
That Demon Within	魔警
The Billionaire	海苔億萬富翁
Young Style	青春派
Our Times	我的少女時代
Sorry I Love You	對不起，我愛你
6 Below	我要活下去
Predetined Around Us	緣來是咱倆
Love Ghost	鬼卜怪談
Sun Face	太陽臉
Secretariat	奔騰人生
My Mother	我的母親 (中國電影)
ILO ILO	爸媽不在家
Ace of Sales	銷售奇姬
Be Together	我只要我們在一起
72 Tenents of Prosperity	72家租客
Sex Tape	愛愛上雲端
Odyssey	西遊·降魔篇
Sky Love	戀愛三萬英尺
The Purple House	紫宅
Transformers: Revenge of the Fallen	變形金剛2
An Odyssey of Dreams	童夢—旅美畫家呂游銘的逐夢旅程
The Roommate	小心室友
Wild Card	拳力突襲
キセキ -あの日のソビト-	唱吧!奇蹟!
Dream at the Age Of 86	金色時光
1911	辛亥革命
Hitchcock	希區考克
Atlas Shrugged: Part II	阿特拉斯聳聳肩
Hsue-shen Tsien	錢學森
Avengers: Age of Ultron	復仇者聯盟2：奧創紀元
Young	先鋒之那時青春
Horns	魔角
Live a Love	活路：妒忌私家偵探社
The New Pinocchio	新木偶奇遇記
Brick mansions	玩命特區
Night Mail	死亡郵件
The Bourne Legacy	神鬼認證4
Away We Go	房事告急
Witch Doctor	妖醫
I, Daniel Blake	我是布萊克
The Home Song Stories	意
A Haunted House 2	鬼屋電影2
Ride Along	一路前行
The Simpsons Movie	辛普森家庭電影版
The Hunger Games: Mockingjay - Part 2	飢餓遊戲：自由幻夢 終結戰
P.S. I Love You	PS.我愛妳
Maps to the Stars	寂寞星圖
The Taking of Tiger Mountain	智取威虎山
Lovelace	A片女神
Don't Knock Twice	別敲兩次門
Dylan Dog: Dead of Night	死人之夜
Blowflish	河豚
The Invasion	恐怖拜訪
Good Morning, Winter Sea	早安，冬日海
Epic	森林戰士
All's Well Ends Well Too 2010	花田囍事2010
Gun Transit	槍過境
I Miss U	屍戀人
Urban Games	城市遊戲
沈まぬ太陽	不沉的太陽
Maze Runner: The Death Cure	移動迷宮3
Sing	歡樂好聲音
Coincidence	凡人煩惱
Bright Star	璀璨情詩
Tales From The Golden Age	黃金年代狂想曲
Paranormal Activity 3	鬼入鏡3
Chronicle of My Mother	我的母親手記
My Sassy Hubby	我老公唔生性
The Mobfathers	選老頂
Fathers and Daughters	幸福再敲門
Who's the One	找個高富帥
Much Ado About Nothing	無事生非
Cats & Dogs: The Revenge of Kitty Galore	貓狗大戰：珍珠貓大反撲
Shanghai Calling	紐約客@上海
Make Me Shudder	這個高中沒有鬼
Season of the Witch	魔女神兵
Murmur of the Hearts	念念
The September Issue	時尚惡魔的聖經
Immortals	戰神世紀3D
Machine Gun Preacher	重裝教士
Repo Men	索命條碼
Magic Card	魔卡行動
Prometheus	普羅米修斯
What The Snow Brings	向雪許願
Return to Sender	控制遊戲
Howl	嚎囂
Black Butterflies	黑蝶漫舞
Funny Soccer	笑林足球
Love Forward	愛要向前沖
Unusual Love	驚情
Pan	潘恩：航向夢幻島
I Am NeZha	我是哪吒
Together	倖存日
Kung Fu Dunk	功夫灌籃
K-20 怪人二十面相・伝	K-20:怪人二十面相
Are You Here	碟仙碟仙
Guia In Love	燈塔下的戀人
Happening	破天慌
The Farewell Party	快樂告別的方法
Lessons in Dissent Movie	未夠秤
American Gangster	美國
The soul of bread	愛的麵包魂
Maggie's Plan	NY單身日記
Young Dudes	騷人
The Game Plan	超級盃奶爸
The Wall	危牆狙擊
Hansel and Gretel: Witch Hunters	女巫獵人
Downsizing	縮小人生
Alpha and Omega	叢林有情狼
Faust	浮士德-魔鬼的誘惑
I Spit on Your Grave	我唾棄你的墳墓
Suffragette	女權之聲：無懼年代
This Means War	特務愛很大
Heart With The Sun	心語陽光
Revolution Places Manufacture	邊區造
My Own Swordsman	武林外傳
White Lily	白百合之戀
Life Without Principle	奪命金
Jungle Master	綠林大冒險
Detective Chinatown	唐人街探案
Lost In White	冰河追兇
After Lucia	露西亞離開之後
Biutiful	最後的美麗
Stories We Tell	莎拉波莉家庭詩篇
The Beautiful Person	巴黎小情人
The Pink Panther 2	粉紅豹2
Zombie 108	Z-108棄城
A Good Day to Die Hard	終極警探：跨國救援
Tokyo Sonata	東京奏鳴曲
Journey to the West: Conquering the Demons	西遊：降魔篇
The Chaser	追擊者
A Taxi Driver	計程車司機
Hoed to you	借你倆膽
Bad Teacher	霸凌女教師
Chongqing Blues	日照重慶
The Buddha's Shadow	神通佛影
Suddenly Seventeen	28歲未成年
President	總統
Titanic	鐵達尼號
The Promise I Made to You	那年我對你的承諾
Ai Zai Wei Bo Man Yan Shi	愛在微博蔓延時
Breakup Buddies	心花路放
The Fourth Portrait	第四張畫
Maiko Haaaan	舞妓哈哈哈
Where the Wind Settles	風中家族
The Zodiac Mystery	十二星座離奇事件
Escape Route	奪路而逃
A Dongguan Girl	東莞女孩
Ajami	遠離阿雅米
Water Lilies	愛上壞女孩
Fallen	墮落天使
8000 Miles from Hip Hop	屌人
The Twilight Saga: Breaking Dawn Part 2	暮光之城：無懼的愛4：破曉
The Giver	記憶傳承人：極樂謊言
The Breakup Guru	分手大師
The Last Chance: Diary of Comedians	我們的交換日記
Side effects	藥命關係
Peeples	皮爾普斯一家
Stray Dogs	郊遊
Mustang	少女離家記
Crazy Love	愛情狂想曲
Timeless love	時光戀人
Little man	美男記
Midnight in Paris	午夜·巴黎
On The Nan Ni Wan Frontier	南泥灣
Last Night	一夜情迷
Zombies Reborn	無間罪：殭屍重生
Coming In	歡迎光臨愛情沙龍
Au Revoir Taipei	一頁台北
Piranha 3-D	3D食人魚
Lost in the Pacific	蒸發太平洋
Goust Double	致命替身
Wish Upon	奪命潘朵拉
The Loner	何去何從
Let go for love	幸福中轉站
To the Wonder	愛‧穹蒼
Five Besties: Divorce Busting	五女鬧京城
Young Ones	旱地復仇
Today and Tomorrow	今天明天
The Devil Inside	心魔
Captain America: The First Avenger	美國隊長
City Without Baseball	無野之城
I Can Speak	花漾奶奶秀英文
Pee Mak Phrakanong	淒厲人妻
Dont Go Breaking My Heart	單身男女
We're the Millers	全家就是米家
Miss You Already	已經很想妳
Andre Gregory: Before and After Dinner	晚餐前後
Stoker	慾謀
La La Land	樂來越愛你
Man Up	冒牌情緣
S Storm	S風暴
Attitude :The Movie	態度
Mediterranean Food	地中海廚娘
Goodess Era	女神時代
3AM 3D Part 2	鬼三驚2
Good Take Too	打開我天空
Dream House	惡靈凶宅
Fruit Story	水果寶貝之水果總動員
Tulpan	圖班嫁給我
Prayers for Bobby	為巴比祈禱
Gone With the Time	再見我們的十年
Shining Dancing	舞力四射
Legend of The T-dog	命運狗不理
GATAO 2	角頭2:王者再起
Radin !	金金計較
Bite	變蟲人
The Tillman Story	橄欖球星之死
Platinum Data	白金數據
Bedtime Stories	天方夜談
エクスクロス　魔境伝説	活人祭
Nomad: The Warrior	游牧英豪
Tsunami	大浩劫
The flight of youth	飛揚的青春
Rogue One: A Star Wars Story	星際大戰外傳:俠盜一號
An End To Killing	止殺令
The Best Plan Is No Plan	溝女不離三兄弟
Dear Friends ディア フレンズ	二分之ㄧ的友情
For Love, We Can	愛不難
Resident Evil: Retribution	惡靈古堡5：天譴日
Heaven In the Dark	暗色天堂
The Man from Nowhere	大叔
Four Lions	四個傻瓜
Foolish Plan	呆呆計劃
The Divergent Series: Insurgent	分歧者2：叛亂者
The Firefox of Bunnington Burrows	兔子鎮的火狐狸
Criminal	換腦行動
Sunflowers in full bloom	向陽花開
The Visit	探訪
Chatroom	聊天弒
One Mile Above	轉山
Mazu Procession	媽祖迺台灣
Interstellar	星際效應
Project Hashima	鬼城
The Ultimate Winner	贏家
I Do Want My Money Back	非常綁架
Bump In The Road	一路順瘋
Date Night	約會喔麥尬
Night of Adventure	瘋狂72小時
Les Misérables	悲慘世界
Bleach	死神劇場版
Into the Storm	直闖暴風圈
To Love Somebody	求愛嫁期
Lonely Island	孤島
Red	超危險特工
Zombeavers	狸老屍卡好
Barefoot	赤足天使
Target	狙擊時刻
Justin Bieber: Never Say Never	小賈斯汀：永不說不
Dorothy Mills	附身
Love in the Late Autumn	愛在深秋
Pleasant Goat and Big Big Wolf– Amazing Pleasant Goat	喜羊羊與灰太狼大電影7：羊年喜羊羊
August Rush	把愛找回來
Make Me Shudder 3	這個高中沒有鬼3
Splice	人工進化
With Love... from the Age of Reason	給未來的我
Money Game	黃金福將
Fan Ju Ye Feng Kuang	飯局也瘋狂
Twilight Online	恐怖在線
Deadly Will	囧探佳人
The Lion Roars 2	河東獅吼2
A Beautiful Life	不再讓你孤單
隠し砦の三悪人	黃金公主
9 Songs	九歌
When In Rome	羅馬不思議
Crosscurrent	長江圖
A Journey, through Time, with Anthony	陪安東尼度過漫長歲月
Coherence	彗星來的那一夜
The Young Messiah	少年彌賽亞
The Bad Lieutenant: Port of Call New Orleans	爆裂警官
Moonlight	月光下的藍色男孩
Triple Tap	鎗王之王
Headshot	迎頭重擊
King of Devil's Island	我的青春煉獄
Godbeast Megazord: Return of Green Dragon	神獸金剛之青龍再現
Winchester	溫徹斯特鬼屋
Packages from Daddy	心靈時鐘
You Will Meet a Tall Dark Stranger	命中注定，遇見愛
Sister Smile	修女愛唱歌
The Other Woman	婦仇者聯盟
Welcome	愛的自由式
Elanne Starlight	愛在星空下
Breath	窒息情慾
Thermae Romae II	羅馬浴場2
Bridesmaid	伴娘幫幫忙
Messi	球神梅西
EVA	EVA奇機世界
Déjà vu	我要你開花
Personal Shopper	私人採購
Day And Night	日夜激情
8 dates	來約會8
Chrysanthemums Terrace	菊花台
Enthralled	愛．尋．迷
LOL	巴黎LOL
Scott Pilgrim vs. the World	歪小子史考特
Doomsday Party	末日派對
Soul	失魂
Fantôme, Où es-tu	酷馬
Beyond Beauty - TAIWAN FROM ABOVE	看見台灣
Lights in the Dusk	薄暮之光
War of the Arrows	弓箭之戰
Transformers: The Last Knight	變形金剛5
The Wasted Times	羅曼蒂克消亡史
The Raid 2: Berandal	全面突襲2：拳力進擊
A Prophet	大獄言家
Mission: Impossible 5	不可能的任務5
3D Sex and Zen: Extreme Ecstasy	3D肉蒲團之極樂寶鑑
No where to hide	男極探射燈
The True Love	不愛不散
Happy Hotel	樂翻天
The Grandmasters	一代宗師
Countdown	倒數夜驚魂
Finding Mr. Right	北京遇上西雅圖
Love Is Not Blind	失戀33天
Hedi	推銷員之戀
Call Me by Your Name	以你的名字呼喚我
Fighting	一號目標
Fast & Furious 6	玩命關頭6
Go Lala Go	追婚日記
Starry Starry Night	星空 (2011年電影)
Mr. Tree	Hello！樹先生
Fantastic Water Babes, The	出水芙蓉
Roomless	不設房
The Page Turner	琴謎變奏曲
Pororo's Racing Adventure	波魯魯冰雪大冒險
Knight of Cups	聖杯騎士
Renegades	潛龍突擊隊
The Boy and The Beast	怪物的孩子
Under The Temptation	四戒
Cowboys & Aliens	星際飆客
Thanatos, Drunk	醉·生夢死
Last Chance Harvey	愛,從心開始
The Darkest Hour	黑暗時刻
My Bloody Valentine 3-D	3D血腥情人節
The One I Love	愛的就是你
Fist & Faith	青禾男高
King Tea Storm	鬥茶
Incendies	烈火焚身
My Blueberry Nights	我的藍莓夜
In the Name of the King	末日危城：王者之役
Snow Flower and the Secret Fan	雪花與秘扇
Vicky Cristina Barcelona	情遇巴塞隆納
Alex Cross	FBI重裝戒備
Marry Me!	假掰新郎
Black Pupil	黑瞳
Paris Holidays	巴黎假期
Mad Money	有錢真好
Temptation: Confessions of a Marriage Counselor	一位婚姻顧問的自白
The Conjuring 2	厲陰宅2
Dead in 3 Days	活三更
Future X-Cops	未來警察
Call of Heroes	危城
A Golden Boy	謎情三弦
A Minute More	只要一分鐘
Monsieur Lazhar	再見了,拉札老師
Blended	當我們混在一起
Seediq Bale Part2	賽德克•巴萊(下)：彩虹橋
Love, Rosie	親愛的，原來是你
Life, Animated	動畫人生
Dear, don’t be Afraid	親，別怕
White Lies, Black Lies	失控謊言
Last Vegas	賭城大丈夫
The Wonderful Wedding	大囍臨門
Hall Pass	放風通行證
Glory Days	光輝歲月
The Tag-Along 2	紅衣小女孩2
Ways Into Love	來得及說再見
Never Gone	致青春·原來你還在這裡
Mole Of Life	黑白
The Deathday Party	死亡派對
Star Wars: Episode I - The Phantom Menace	星際大戰首部曲：威脅潛伏3D
Go！Crazy Gangster	風雲高手
Hummingbird	夜刑者
Spooks: The Greater Good	軍情五處：利益之爭
Lion Dancing	鐵獅玉玲瓏
Vacation	全家玩到趴
John Dies at the End	死亡盡頭
The Game Of Hide And Seek	禁忌的遊戲之迷藏
Tokyo Newcomer	初到東京
Crossing Hennessy	月滿軒尼詩
Super Models	色模
続・三丁目の夕日	再續幸福的三丁目
Safe House	狡兔計畫
戰爭製造公司	戰爭製造公司
Wu Ren Bao	吳仁寶
Campus Confidential	愛情無全順
Great Wall My Love	追愛
Sing Street	搖滾青春戀習曲
Magic to Win	開心魔法
I Am Number Four	獵殺第四行者
Seven Days In Heaven	父後七日
The Deadly Bullet	刺夜
Sky Fighters	殲十出擊
War Machine	戰爭機器
Trivisa	樹大招風
Bad Genius	模犯生
The Flush of Dawn	行者三太子─迎向曙光
The Summer Is Gone	八月
Prima Donna	當家花旦
Agora	風暴佳人
HEBEI TAIPEI	河北臺北
僕の彼女はサイボーグ	我的機器人女友
Just Another Margin	大話天仙
Lady Bird	淑女鳥
Emma’s Bliss	艾瑪的禮物
Bodybuilder	重量教育
Tales Dark 2	奇幻夜
The Boar King	山豬溫泉
Mr. Bedman	彈簧床先生
Florence Foster Jenkins	走音天后
Train Heroes	高鐵英雄
Glory to the Filmmaker	導演萬歲
Patrik Age 1.5	派翠克一歲半
Mr.Lucky	好命先生
Happiness Me Too	幸福迷途
Born in China	我們誕生在中國
Movie 43	激愛543
Don't Open The Door	別開門
Step Up All In	舞力全開5
Rebirth	第八日的蟬
Like Dandelion Dust	蒲公英的灰塵
Stonewall	石牆風暴
Beijing Blues	神探亨特張
Ladda Land	陰地
Odds in Love	愛情鬥陣
Chiu-Hsiang	秋香
Kunfu Heros	功夫四俠
A Busy Night	情況不妙
Mr. Bean's Holiday	豆豆假期
Pompeii	龐貝
Bloody House	筆仙詭影
Hua Zhuang Shi	化妝師
Ever Loving Ocean Of Blues	藍調海之戀
The Suspicious	最佳嫌疑人
Fish Tank	發現心節奏
The Big Sick	愛情昏迷中
Promise Time	玩命時光
Super Express	超級快遞
Shrek the Third	史瑞克三世
Give me a kiss	親親我
The Old Cinderella	脫軌時代
Kaili Blues	路邊野餐
Fast & Furious 7	玩命關頭7
Snow Fall in Taipei	台北飄雪
Journey to the Center of the Earth	地心冒險
KIDS	超感應
Machete	絕煞刀鋒
The Posterist	海報師：阮大勇的插畫藝術
Brad's Status	人生剩利組
Welcome Home Roscoe Jenkins	怪咖一家親
Gallows Hill	闇魔怨
Perfect Sense	末日情緣
Drag Me to Hell	地獄魔咒
Dark Flight 3D	3D鬼機8
Endless Love	愛你一生一世
I'm Handsome	我很帥
I Phone You	愛封了
Alibaba and The Thief<	阿里巴巴：大盜奇兵
Eating Out: The Open Weekend	外出用餐5
Ox Thief	牛膽神偷
Melody's Smile	微笑標本
Three	三人行
Changeling	陌生的孩子
My Brilliant Life	噗通噗通我的人生
The Prospector	探秘者
My Ol' Classmate	同桌的你
Second Chance	逆轉勝
To Each His Own	不幹了！我開除了黑心公司
Million Dollar Arm	百萬金臂
Corrections Class	廢青同盟
The White Lie	火雲端
Closet Monster	愛人怪物
Mysterious Island	孤島驚魂
Love the Coopers	庫柏一家
3 Idiots	三個傻瓜
Jem and the Holograms	芙蓉仙子
The Legend of Qin	秦時明月大電影之龍騰萬里
The Belko Experiment	辦公室大狂殺
Cheap Thrills	絕命賭局
Fraulein	三十而麗
We Own the Night	萬惡夜總會
Ocean Heaven	海洋天堂
The Look of Silence	沉默一瞬
An Flying Arrow	駱駝客2之箭在弦
Now You See Me: The Second Act	出神入化2
Bridge of Spies	間諜橋
Green Zone	關鍵指令
Ever Since We Love	萬物生長
Inky Soul	墨魂
To my wife	與妻書
Jurassic World: Fallen Kingdom	侏羅紀世界2
Nitro Rush	終極車陣: 飆出重圍
The Divide	崩裂:毀滅殺陣
A Glimpse Inside the Mind of Charles Swan III	變腦漫遊中
The Spirit of the Swords	情劍
The People I've Slept With	姣妹日記
Rosewater	叛諜風暴
Avalokitesvara	不肯去觀音
My Love Story!!	俺物語!!
Emotional Arithmetic	巴黎心楓葉情
The LEGO Movie	樂高玩電影
The Blue Bird	青鳥
To Love or Not	一夜未了情
Bear It	熊熊愛上你
When Marnie Was There	回憶中的瑪妮
Obsessed	人間中毒
The Zero Theorem	明日定律
The Harbor	港都
The Best Offer	寂寞拍賣師
Lottery Ticket	瘋狂大樂透
The Fighter	燃燒鬥魂
Cherry Tree	陰桃術
Love sick	戀愛恐慌症
Battleship	超級戰艦
The Woodsman and the Rain	啄木鳥與雨
Mongol	鐵木真:開天闢地
A Jewish Girl in Shanghai: The Mystery of the Necklace	猶太女孩在上海2：項鍊密碼
14 Blades	錦衣衛
Love of the Sea	海洋之戀
Star of bethlehem	微光閃亮第一個清晨
Footloose	2011渾身是勁
人のセックスを笑うな	不要嘲笑我們的性
Sucker Punch	殺客同萌
The Floating Shadow	浮出水面的影子
Dragonball	七龍珠
The Gift	非禮勿弒
End of the Spear	亞馬遜悲歌
Ted 2	熊麻吉2
Insidious: Chapter 2	陰兒房第2章：陰魂守舍
Where Are You From?	你是哪裡人
KIASU	做你愛做的事
Ouija	碟仙
Sparkle	璀璨人生
Honeymoon	血色蜜月
Gukoroku-Traces of Sin	愚行錄
Exit Marrakech	流浪摩洛哥
Oldboy	原罪犯
Half Nelson	我的左派老師
Sashimi	沙西米
Outside The Law	光榮時刻
The Last Days on Mars	星際禁區
The Hurt Locker	危機倒數
Angels &amp; Demons	天使與魔鬼
Amour	愛•慕
The Ravine of Goodbye	再見溪谷
Burn After Reading	即刻毀滅
They Call Me Jeeg	叫我鋼鐵俠
Balala the Fairies	巴啦啦小魔仙大電影
Shen Zhou 11	飛天
Buddha: The Great Departure	佛陀：首部曲
After Spring, the Tamaki Family	海的彼端
The Horizon of The Child	天邊的孩子
The Story Of David	蛋炒飯
Better Living Through Chemistry	毒醉心迷
Jump A Shin	翻滾吧！阿信
Battle Up!	舞鬥
The Apparition	幻影
DIVE!!　ダイブ!!	跳水男孩
Surprise	萬萬沒想到：西遊篇
Death Note	死亡筆記本
Love Strikes!	草食男之桃花期
28 Weeks Later	28週毀滅倒數
Mr. Go	王牌巨猩
No.32,B District	B區32號
Hong Kong Ghost Stories	猛鬼愛情故事
Planet B-Boy	街舞開戰
Knock Knock Who's There?	有客到
District 9	第九禁區
Fast Five	玩命關頭5
GG Bond 2	豬豬俠之勇闖巨人島
Legend Of The Moles-The Magic Train Adventure	摩爾莊園大電影3：魔幻列車大冒險
Broken Embraces	破碎的擁抱
Kung Fu Man	功夫俠
She and She	黑月
Phantom of the Opera at the Royal Albert Hall	歌劇魅影舞台版
Battle Up！	舞鬥
Clownfish	小丑魚
The Wrestler	力挽狂瀾
Let The Bullets Fly	讓子彈飛
Angels & Demons	天使與魔鬼
The Purge: Election Year	國定殺戮日3
Looking for Eric	尋找艾瑞克
Transcendence	超越那一天
Rise of The Rice Cooker	麥兜．飯寶奇兵
Initiation Love	愛的成人式
Embrace of the Serpent	夢遊亞馬遜
You Zhao Mei Zhao	有招沒招之愛情達人
Lock Me Up,Tie Him Down	完美假妻168
Taichi0	太極1從零開始
Don't Be Afraid of the Dark	別怕黑
Parasyte Part 1	寄生獸1
Mural	畫壁
The Charge	衝鋒號
child 44	第44個孩子
Hairspray	髮膠明星夢
4 in Life	四季人生
A Woman Goes to the Doctor	陪妳到最後
Therapy for a Vampire	吸血鬼腥靈診療
Precious	珍愛人生
The Smurfs	藍色小精靈
Death at a Funeral	新超完美告別
Mayday 3DNA	五月天追夢
No Limit	危情速遞
Coweb	戰．無雙
Yugo & Lala 3	神秘世界歷險記3
Q	巴黎Q孃
The Purge: Anarchy	國定殺戮日：無法無天
Tour de Force	騎動人生
The Bloom of Yesterday	昨日盛開的花朵
Queens	我的酷兒婚禮
Step Up 2 the Streets	舞力全開
Iron Man Wang Jin Xi	鐵人王進喜
The Disappearance of Eleanor Rigby	因為愛情
Despicable Me 3	神偷奶爸3
Your Highness	王子殿下
Tinker Bell and the Great Fairy Rescue	奇妙仙子：拯救精靈大作戰
Spy Kids 4: All the Time in the World	小鬼大間諜4
Compass	鬥龍戰士之星印羅盤
Master of Pretending	假裝看不見之電影大師
Unmissable	不能錯過
The Second Best Exotic Marigold Hotel	金盞花大酒店2
Beaufort	前陷風暴
The Great Gatsby	大亨小傳
Fall in Love With You	這個大叔不太囧
Hot Tub Time Machine	扭轉時光機
The Human Centipede	人形蜈蚣
Flying Dragon, Dancing Phoenix	龍飛鳳舞
The Break-Up Artist	分手達人
First Of May	五月一號
Happy Heroes 2 Qiyuan Planet Wars	開心超人2：啟源星之戰
Whatever Works	紐約遇到愛
L for Love, L for Lies Too	失戀日
The Expatriate	關鍵追擊
Ju-on: the Final Curse	咒怨:最終章
The Smurfs 2	藍色小精靈2
Don't Run the Thief	笨賊別跑
My Best Friend’s Wedding	我最好朋友的婚禮
X-Men Origins: Wolverine	X戰警: 金鋼狼
For Grace	獻給米其林的生命貴客
The Disappearance of Alice Creed	愛麗絲蒸發奇案
The Great Wall	長城
Le secret	賣百科全書的女人
Our Time Will Come	明月幾時有
Yang Shan-zhou	楊善洲
Iron Man 2	鋼鐵人2
釣りキチ三平	天才小釣手
The Model	時尚帝國合約的開始
Into the Woods	魔法黑森林
Elysium	極樂世界
Insidious	陰兒房
Road to the Sky	情比山高
A Big Deal	巨額交易
What We Do In The Shadows	吸血鬼家庭屍篇
Final Destination: Death Trip 3D	絕命終結站4
The Flight of the Red Balloon	紅氣球
GG Bond Movie:Ultimate Battle	豬豬俠之終極決戰
Pixels	世界大對戰
Tangled	魔髮奇緣
Blowfish	河豚
Love Needs One More Night	一見未鍾情
Everest	聖母峰
Balala The Fairies-Princess Camellia	巴啦啦小魔仙之魔箭公主
Edge of Darkness	驚爆萬惡城
The Sessions	性福療程
Paradise in Service	軍中樂園
River of Belief	太陽河
Priest	獵魔教士3D
The Chronicles of Narnia: Prince Caspian	納尼亞傳奇：賈思潘王子
Mr. Popper's Penguins	波普先生的企鵝
Huang Dao Qing Wei Liao	荒島情未了
Valkyrie	代號：華爾奇麗雅
San Andreas	加州大地震
About Time	真愛每一天
Get Him to the Greek	前往希臘劇院
Bangkok Knockout	玩命KO
Enemy	雙面危敵
White Deer Plain	白鹿原
Love,Rosie	真愛繞圈圈
Abduction	在劫難逃
The Teacher's Dairy	教師日記
Max Payne	麥斯潘恩
I Killed My Mother	聽媽媽的話
The Perfect Girl	最完美的女孩
Capital	資本遊戲
Fall In Love Like A Star	怦然星動
White Ant	白蟻:慾望謎網
Love Finally	男得有愛
New York, I Love You	紐約我愛你
Red Dawn (2012)	紅潮入侵
Spy	麻辣賤諜
Kevin Hart: Let Me Explain	讓我解釋
Dawn of the Planet of the Apes	猩球崛起：黎明的進擊
Noriko's Dinner Table	紀子出租中
Horror Love Story Wrong Way	恐怖愛情故事之死亡公路
J. Edgar	胡佛傳
Fairy Impac Disc Fairy	筆仙撞碟仙
Detective Conan Episode One	變小的名偵探
Ghost in the Shell	攻殼機動隊
Who Am I 2015	我是誰2015
Oz: The Great and Powerful	奧茲大帝
Inherent Vice	性本惡
All About Them	我愛妳,妳愛她
Wind Chimes On The Card	風鈴上的卡片
The Lucky Ones	真情旅程
Think Like a Man Too	男人行不行2
Goodbye Bafana	再見曼德拉
Battle of the Year	BOTY世界Battle
The young touts the big Yu treasure	少年師爺之大禹寶藏
Face Hunter	虐面人之死靈面膜
Blue Sky Bones	藍色骨頭
Love For Life	最愛
Vita Activa: The Spirit of Hannah Arendt	漢娜鄂蘭─思想的行動
The Black Balloon	吾愛無悔
The Kid with a Bike	騎單車的男孩
Shutter	鬼照片
The Peanuts Movie	史努比
The Secret Life of Walter Mitty	白日夢冒險王
Love Godfathers	戀愛教父之三個壞傢伙
Sui Sui Qing Ming	歲歲清明
The Book of Eli	奪天書
Point Blank	活命條件
Chronicles of the Ghostly Tribe	九層妖塔
Horrible Hotel	恐怖旅館
One Step Away	觸不可及
The 17th Journey of Compassion	乘願再來九百年
The warloads	投名狀
The Boss of It All	老闆我最大
Vacancy	針孔旅社
My Sister's Keeper	姊姊的守護者
Hitman: Agent 47	刺客任務：殺手47
Trapped at Sea, Lost in Time	海上情書
Everything is Nothing	神馬都是浮雲
Sherlock Holmes	福爾摩斯
A Young Girl's Destiny	逆襲
From Vegas to Macau	賭城風雲
Dad's Cabin	爸爸的木房子
A Tiger Wife	家有虎妻
Omar	奧瑪的抉擇
Journey 2: The Mysterious Island	地心冒險2：神祕島
Sweet Journey	雲下的日子
Besieged City	圍城
Runaway Women	暴走吧，女人
Full Strike	全力扣殺
My Old Lady	巴黎窈窕熟女
Tour De Force	生命騎士
Saving General Yang	忠烈楊家將
Seven Something	愛無7限
Trumbo	好萊塢的黑名單
Nekonade	心動奇蹟2
The 9th Life of Louis Drax	路易的第9條命
The Flowers Of War	金陵十三釵
Heartbeats	舞動心跳
G.P. 506	惡靈碉堡
Captain Phillips	怒海劫
Detective Dee	通天神探狄仁傑
Leaving Gracefully	帶一片風景走
Phantom Thread	霓裳魅影
Apolitical Romance	對面的女孩殺過來
Closed Doors Village	封門村
Miss Kicki	霓虹心
New Minesweepers Warfare&#160;: Courageous boy	新地雷戰：神勇小子
On the Road	浪蕩世代
Carol	因為愛你
Poseidon Code	海神密碼
Iron Man 3	鋼鐵人3
The Autopsy of Jane Doe	驗屍官
Sleeping with Other People	愛睡在一起
Friends with Benefits	FWB好友萬萬睡</a>/<a href="/wiki/%E6%88%80%E6%90%9E%E5%A5%BD%E6%9C%8B%E5%8F%8B" title="FWB好友萬萬睡">FWB好友萬萬睡
Jack the Giant Killer	傑克:巨人戰
Pay The Ghost	邪尋
Saving Christmas	拯救聖誕節
Going the Distance	真愛零距離
LIVE IN LIVE	現場·戰場·夢工廠
A Dog's Purpose	為了與你相遇
Fish Story	子非魚
A.P.T	詭公寓
Paddington	柏靈頓：熊愛趴趴走
The Three Musketeers	劍客聯盟：雲端之戰
Little Knights	小騎士闖通關之美夢成真
Foxcatcher	暗黑冠軍路
Feast of Love	愛情盛宴
Empire of Silver	白銀帝國
Red Like The Sky	聽見天堂
MBA Partners	夢想合伙人
What Maisie Knew	梅西的世界
Anonymous	莎士比亞的祕密
Incredibles 2	超人特攻隊2
I Am Somebody	我是路人甲
Silk	異旅情絲
You're Next	你是下一個
The Hitman’s Bodyguard	殺手保鑣
The Grand Masters	一代宗師
47 Meters Down	深海鯊機
Macbeth	馬克白
Qing Chun Shi Le Yuan	青春失樂園
What We Did on Our Holiday	這個夏天的秘密
Death Defying Acts	魔幻奇緣
Tinker, Tailor, Soldier, Spy	鍋匠 裁縫 士兵 間諜
Hip-Hop Storm	街舞狂潮
The Elite Squad 2	精英部隊2：大敵當前
The Spiderwick Chronicles	奇幻精靈事件簿
Stolen	盜數計時
Mole of Life	黑白
A Chorus of Angels	往復書簡
Youth	年輕氣盛
47 Ronin	浪人47
Swordsmen	武俠
Hellion	刺頭青
Blue Is the Warmest Color	藍色是最溫暖的顏色
A Few Best Man	伴郎我最High
Seven Pounds	七生有幸
Mr.& Mrs. Incredible	神奇俠侶
The Thirty-Seven	三十七
Coriolanus	王者逆襲
The Voice	愛情不等式
Angel Whispers	花街柳巷
Smile Walked	笑過2012
シャカリキ！	鐵馬頑童
Dark Shadows	黑影家族
Close To You	近在咫尺的愛侶
Jumping Boy	不倒翁的奇幻旅程
Control	控制
Just Wright	愛在此時
Summer Love	戀夏戀夏戀戀下
Chappie	成人世界
The 100th Love with You	與妳的第100次愛戀
Les aventures extraordinaires d'Adèle Blanc-Sec	神鬼驚奇
Midnight Garage	三更車庫
Little Tigers	小小飛虎隊
The Detcctive 2	B+偵探
Temporary Family	失戀急讓
Lincoln	林肯
Somewhere Only We Know	有一個地方只有我們知道
La Comédie humaine	人間喜劇
Hidden Diary	隱藏日記本
My Wife Is A Superstar	我老婆係明星
Dinner For Schmucks	豬頭晚餐
Extremely Loud and Incredibly Close	響在耳邊，近在眼前
Be Kind Rewind	王牌自拍秀
The Only Living Boy in New York	紐約寂寞男孩
Green Lantern	綠光戰警
The Raven	神探愛倫坡：黑鴉疑雲
Formosa Betrayed	被出賣的台灣
The Battleship Island	軍艦島
Melancholia	驚悚末日
The Other Man	外慾殺機
The Scroll of Wing Chun White Crane	永春白鶴拳之擎天畫卷
The Rocking Sky	沖天
Love Dog Doc	我的狗狗我的愛
Five Minutes to Tomorrow	深夜前的五分鐘
The Ugly Duckling	瘋狂醜小鴨
Tamara Drewe	塔瑪拉小姐
Beginning of The Great Revival	建黨偉業
The Promised Land	回到被愛的每一天
Waiting for Armageddon	奔向末日
Jersey Boys	紐澤西男孩
The Palace	宮鎖沉香
Space Panda 2	太空熊貓總動員
Wong Ka Yan	王家欣
Flying Colors	墊底辣妹
Midnight Whisper	半夜叫你別回頭
Hapless Thief	囧賊
Yu Shen	預審
Make It Happen	唯舞獨尊
Beyond the Mask	面具之上
The Light Between Oceans	為妳說的謊
The Hole in 3D	3D無底洞
Bring Happiness Home	快樂大本營之快樂到家
Life after Beth	殭屍哪有這麼正
Country Strong	鄉謠情緣
Identity Thief	竊資達人
The Young Yang Jingyu	少年楊靖宇
Children Who Chase Lost Voices from Deep Below	追逐繁星的孩子
Star Wars: The Force Awakens	星際大戰七部曲：原力覺醒
My Way	乾旦路
The Magnificent Nine	殿下萬萬稅
Breathe	我要為你呼吸
Advantageous	2Q41：茱兒的禮物
Out of the Furnace	逃出鎔爐
Detective Conan: The Eleventh Stricker	名偵探柯南16
Hope Springs	希望噴泉
My Voice My Life	爭氣
Captive	隨機人質
Made of Honor	新郎不是我
Tazza 2	千術之神
Mysterious Fece II	枕邊有張臉2
Impossible	不可思異
Echoes Of The Rainbow	歲月神偷
Tunnel	失控隧道
Turbo	渦輪方程式
The Theory of Everything	愛的萬物論
Womb Ghosts	惡胎
Oshin	阿信
-197°C Murder	冰裸殺
The Tribe	過於寂靜的喧囂
Mountain Cry	喊·山
Wish I Was Here	B咖的幸福劇本
Sky of Love	戀空
A Tale From The Orient	天眼傳奇
The Love Of Three Smile-Scholar And The Beauty	三笑之才子佳人
The Grey	即刻獵殺
House Mania	房不剩防
The light	永遠的守望
The Spin Kid	電哪吒
Goodbye Berlin	再見柏林
You're The Apple Of My Eye	那些年,我們一起追的女孩
Beautiful Creatures	美麗魔物
Shaolin	新少林寺
Rio	里約大冒險
The Viral Factor	逆戰
Luo Jing Shan	落經山
Stranger by the Lake	湖畔春光
My DNA Says I LoveYou	基因決定我愛你
People Mountain People Sea	人山人海
The Descendants	繼承人生
Tiny Times 1.0	小時代
Living The Game	我在快打求旋風
David Loman2	大尾鱸鰻2
101st Marriage Proposal	101次求婚
Cock and Bull	追兇者也
Love in Vain	獨一無二
Oppai Volleyball	巨乳排球
Dear White People	親愛的白人
A Thousand Times Good Night	一千次晚安
Love Off the Cuff	春嬌救志明
I Give My First Love to You	我的初戀情人
Alice Through the Looking Glass	魔境夢遊2
X-Men: First Class	X戰警：第一戰
Still 2	凶地
Before I Fall	還有機會說再見
Youth.com	青春.com
My Blind Date With Life	看見5%的奇蹟
Ocean's 8	瞞天過海:八面玲瓏
The Good Dinosaur	恐龍當家
Wu Dang	大武當之天地密碼
Heartbreaker	戀愛救火隊
Foolish Plans	發條城市
Jack and Jill	傑克與吉兒
Stool Pigeon, The	綫人
Phantom	幻影計劃
One Journey, One Mission	有任務的旅行
Smuggler	搬運你的未來
Orphan	孤兒怨
Iceman 3D	3D冰封俠：重生之門
Buppha Reborn	609
The Gallows	絞刑台
The Calligraphy Master	啟功
How to Train Your Dragon	馴龍高手
When the Meteor Shot Across the Sky	當流星划過天際
The Piano In A Factory	鋼的琴
Me and Kaminski	大藝術家與我
The Crossing Part 1	太平輪：亂世浮生
The Karate Kid	功夫夢
A Cure For Wellness	救命解藥
Rise of the Guardians	捍衛聯盟
Song of Silence	楊梅洲
Persepolis	茉莉人生
The Winner	聖誕大贏家
The bloody marriage	死亡迷局
Trouble with the Curve	人生決勝球
The Constable	衝鋒戰警
Percy Jackson & The Olympians: The Lightning Thief	波西傑克森:神火之賊
Tangerines	橘子收成時
The Last Exorcism	最後大法師
New Perfect Two	新天生一對
My Geeky Nerdy Buddies	大宅們
30 Minutes or Less	菜鳥搶銀行
This is Where I Leave You	愛在頭七天
The Little	小角色
Pretty Maid	一個溫州的女人
Sound of Noise	噪反城市
First Girl I Loved	初戀上女孩
The Empress And The Warriors	江山美人
Insidious 4: The Last Key	陰兒房第4章
The Expendables 2	浴血任務2
Age of Glory	鋼鐵，是這樣煉成的
Wu Lin Tan Mi	武林探秘
The Age of Innocence	純真年代
Pressure	深海逃脫
The Interview	名嘴出任務
Dredd	新特警判官
Green Room	納粹龐克
When C Goes with G7	當C遇上G7
Tiny Times 2	小時代 2&#160;: 青木時代
The Gathering	同學會
Love is Sin	白天的星星
Air Doll	空氣人形
Just Between Us	親子與精子
Land of Mine	拆彈少年
Final Project	玩謝大師
FIooing Around Jiang Hu	江湖悲劇
Pusu Qhuni	餘生—賽德克·巴萊
Lips and Soul	唇唇欲動
The Good Guy	尋找完美情人
Mrs. Ratcliffe's Revolution	老娘鬧革命
Farm House II	81號農場之瘋狂的麥咭
Valerian and the City of a Thousand Planets	千星之城
Romulus, My Father	我的父親魯木斯
Deslie for Young	渴望的青春
22nd Catch	22個男人
American Hustle	瞞天大佈局
Kidnapping Mr. Heineken	綁架海尼根
John Wick	捍衛任務
Color Me Love	愛出色
A Secret Between Us	第一次不是你
Stealing Legend	國寶疑雲
Go Lala Go！	杜拉拉升職記
Night at the Museum: Secret of the Tomb	博物館驚魂夜3
Love Distance	愛別離
Youth is A War	青春一戰
Someone Behind You	背後靈
Race to Witch Mountain	超異能冒險
A Better Tomorrow	英雄本色
犬と私の10の約束	與狗狗的十個約定
Brave Hearts: Umizaru	海猿4:終極救援
The Losers	敗者為王
The Missing Picture	遺失的映像
A Quiet Place	噤界
WuKong	悟空傳
Thanks for Sharing	謝謝分享,我的愛
22 Jump Street	龍虎少年隊：童顏巨捕
L-O-V-E	愛到底
Meet The Pegasus	喜羊羊與灰太狼之飛馬奇遇記
Miracle in Cell No. 7	戇爸的禮物
The Eagle	帝國戰記
Shame	性愛成癮的男人
Under The Bed 2	床下有人2
The adventures of the ugly duckling	醜小鴨歷險記
The Cartel War	掃毒
Madagascar 3: Europe's Most Wanted	馬達加斯加3：歐洲大圍捕
Francofonia	攻佔羅浮宮
Mr. Turner	畫世紀:透納先生
Despicable Me	神偷奶爸
Earth	我們的地球
Striving in Beijing With Love	愛拼北京
ATM	提款機
If I Stay	如果我留下
Phantom of the Theatre	魔宮魅影
Tarzan	泰山
Lock Me Up Tie Him Down	完美假妻168
Floating City	浮城
The Spiritual World	屍魂落魄
The Crucifixion	刑弒厲
Trivial Matters	破事兒
A Story of Yonosuke	横道世之介
Victoria	維多莉亞
Dolphin Tale 3D	海豚的故事
Bordertown	亡命殺鎮
Himalaya: Ladder to Paradise	喜馬拉雅天梯
Babysitting	褓姆Hold不住
Nightcrawler	獨家腥聞
The Tenants Downstairs	樓下的房客
Terminator Genisys	魔鬼終結者：創世契機
Grand Central	愛慾來襲時
Better And Better	越來越好之村晚
Godspeed	一路順風
All's Well End's Well 2011	最強囍事
Fear Is Coming	恐怖將映
Singing When We Are Young	初戀未滿
To Save a Life	珍愛生命
Dad, Where Are We	爸爸去哪兒
Legion	暗黑天使
You Are the Apple of My Eye	那些年，我們一起追的女孩
82 Warriors	劉老莊八十二壯士
Only You	非你勿擾
Formosa Mambo	寶島漫波
The Shining Candle	一江明燭
Instructions Not Included	重點是，我愛你
Running Man	奔跑吧兄弟
The Transporter Refueled	玩命快遞：肆意橫行
Unlocked	全面封鎖
Death Trip	還魂之迷失曼谷
Ex File	前任攻略
Another Gay Movie	酷兒同玩派
House At The End of the Street	地下弒
Bullet to the Head	頭號目標
Galaxy Turnpike	銀河街道
The Riot Club	高富帥俱樂部
Get Hard	獄前教育
The Cove	血色海灣
Bright Sunshine	大太陽
The Brothers-The Drifting Singer In Beijing	兄弟之北漂歌手
Harry Potter and the Deathly Hallows - Part 2	哈利波特7.2
Creepy	恐怖鄰人
Draft Day	超級選秀日
Carrie Pilby	哈佛沒教的幸福課
Cash	至尊對決
Step Up Revolution	舞力全開4
The Rebirth of a Flourishing City	孕城
Snow White The Power of Dwarfs	白雪公主之矮人力量
Annabelle 2	安娜貝爾2
Lost In Hong Kong	港囧
Lebanon	黎巴嫩
The Players	偷情大丈夫
CARS 3	汽車總動員3
Town Creek	鬼哭人嚎
Think Like a Man	讀懂男人心
Ever Been to the Moon	麥田書香
Neighbors 2	惡鄰纏身2
Monsters University	怪獸大學
Flight	機密真相
1924 Mao Zhedong in Shanghai 1924	毛澤東在上海·1924
ゲゲゲの鬼太郎 千年呪い歌	鬼太郎2
Life for Sale	人生,一元起標
The Promise	屍約
The Apology King	謝罪大王
Absent without Leave	不即不離
Red Tails	紅尾戰鷹
Spring Breakers	放浪青春
Sand Pebbles	大浪淘沙
The Wings of the Kirin	麒麟之翼
Cold Souls	靈魂冷凍庫
Nocturna	星星大作戰
Detective Conan: Crimson Love Letter	名偵探柯南21
The Lego Batman Movie	樂高蝙蝠俠電影
Shooter	狙擊生死線
War, Inc.	戰爭製造公司
Pirates of the Caribbean: On Stranger Tides	神鬼奇航：幽靈海
Dallas Buyers Club	藥命俱樂部
The Valet	巴黎換換愛
The Hero of Color City	蠟筆總動員
Rabbit Hole	愛，讓悲傷終結
How are you, Dad?	爸,你好嗎?
Suite Française	亂世有情天
Yang Guang Liu Shou	陽光留守
The Runaways	翹家女聲
Hundred Years of A Floating City	浮城大亨
RocknRolla	搖滾黑幫
The Boys Are Back	親愛的小孩
The Boy in the Striped Pajamas	穿條紋衣的男孩
The Man	硬漢教育
The Perfect Man 	尋找阿娜答
Che	切
A Bigger Splash 	池畔謎情
A Haunted House	鬼屋入鏡
Tragedy Girls	姐姐妹妹殺起來
Universal Soldier: Day of Reckoning 	魔鬼命令4
Harry Potter and the Deathly Hallows - Part 1	哈利波特7.1
Rock School 	搖滾學校
The Boondock Saints II: All Saints Day	神鬼尖兵2
Waiting for Forever	等妳到永遠
The Dead Girl	謎樣女孩死亡事件
November	驚狂十一月
Song One 	真愛戀習曲
House of Wax	恐佈蠟像館
Mission: Impossible 3	不可能的任務3
Casanova	濃情威尼斯
Beowulf & Grendel 	勇士傳奇
From Mexico with Love 	拳頭生涯原是夢
Ong-Bak 3	拳霸終極篇
Shortbus	性愛巴士
Flushed Away	鼠國流浪記
Into the Wild 	阿拉斯加之死
The Hoax	大亨偽傳
Undead	獵殺活死人
The Trip to Italy 	同遊義大利
Lords of Dogtown	衝破顛峰
Grown Ups	亞當
Harold and Kumar Escape From Guantanamo	豬頭漢堡飽2
The Purge: Anarchy 	國定殺戮日2
Breaking News 	大事件
Arthur and the Invisibles	亞瑟
300: Rise of an Empire 	300壯士2
Tucker & Dale vs. Evil	大學生殺了沒
The Hobbit: The Battle of the Five Armies	哈比人3
Anna Karenina	安娜卡列妮娜
2 Days in New York 	紐約二日情
Thelma	女神賽爾瑪
Coraline	第十四道門
Fever Pitch	愛情全壘打
Seeking Justice	私法正義
The Dark Knight Rises	黑暗騎士:黎明昇起
The Dry Land	荒涼大地
Dredd	超時空戰警3D
Turtles Can Fly 	烏龜也會飛
Bravetown	樂動
Requiem	靈界線
Dedication	插畫情緣
Saraband	薩拉邦德舞曲
Nothing Like the Holidays	聖誕佳節
College	大學預備生
Resident Evil: Afterlife	惡靈古堡4
Syriana	諜對諜
Emperor	天皇
You're Next 	下一秒就是你
Mirrors	鬼鏡西洋版
Jonas Brothers:The 3D Concert Experience	強納斯兄弟演唱會
Stealth	機戰未來
The Raid 	反恐精英
Like Crazy	瘋一樣的男子
King's Ransom	國王贖金
Sinister 2	凶兆2:雙瘋
2016: Obama's America 	2016:歐巴馬的美國
Beauty and the Beast 	美女與野獸
Stop-Loss	拒絕再戰
Green Street Hooligans	綠街大火拼
About Last Night 	昨夜風流
Katyn	愛在波蘭戰火時
Hoot	夏日鴞鳴
Somewhere	我的明星老爸
Starter for 10	戀愛學分
Bad Johnson 	強森好屌
The Disappearance of Alice Creed	愛麗絲人間蒸發
Bright	光靈
Heartless	魔鬼契約
Wish I Was Here 	白日夢孩子王
Punisher: War Zone	神鬼制裁2
The Secret of the Grain 	家傳秘方
Miss Potter	波特小姐
Junebug 	妙媳婦見公婆
Sahara	撒哈拉
Avenue Montaigne	巴黎蒙田大道
Valerian and the City of a Thousand Planets 	星際特工瓦雷諾:千星之城
Take Shelter	居安思危
House of D 	傷心往事
Gus Van Sant's Last Days 	成名終點站
Independence Day 2: Resurgence	ID4星際終結者2
Little White Lies 	愛謎藏
Ride Along 	一路靠北
Admission	非關入學
Nasty Baby	寶貝超級壞
Traitor	叛國者
Control	不再克制
Only God Forgives	末路殺神
Jarhead	鍋蓋頭
Harry Potter and the Goblet of Fire	哈利波特4
Chaos Theory	混沌理論
Role Models	模範大哥哥
Black Snake Moan	花痴
Uncertainty	玩命一擲
Winter's Bone	凍死骨
Linsanity	林來瘋
Snow Angels	雪天使
The Grand Seduction	誘惑醫生100招
Just My Luck	幸運之吻
The Ten	哈啦十誡
The Kingdom	反恐戰場
Into the Fire 	風暴過後
Over the Hedge	森林保衛戰
D.E.B.S. 	高校女特務
A Mighty Heart	無畏之心
The Dukes of Hazzard	飆風天王
Domino	女模煞
Pride	榮耀泳隊
The Human Centipede II 	人形蜈蚣2
A Good Old Fashioned Orgy	雜交有益身心
Doogal	毛毛狗
The Choice	抉擇
Are We There Yet?	小鬼上路
The Memory of a Killer 	殺手輓歌
The 40-Year-Old Virgin	40處男
Meet Bill	遇上比爾
The Jane Austen Book Club	珍奧斯汀讀書會
Rize 	熱街勁舞
Madison 	麥迪遜錦標賽
The Edukators	替天行盜
The King's Speech	王者之聲
Paddington	熊愛趴趴走
The Town	竊盜
The Apparition	鬼次元
Tetro	泰特羅
Percy Jackson: Sea of Monsters	波西傑克森2
Notes on a Scandal	醜聞筆記
Separate Lies	婚約裂痕
Blood Ties	烈血風雲
March of the Penguins 	企鵝寶貝
Balls of Fury	乒乓特派員
Playing for Keeps	情場大玩咖
London Has Fallen	全面攻佔2
Pretty Persuasion 	美麗壞姐妹
Exists	神出鬼沒
The Tree of Life	永生樹
Capitalism: A Love Story	資本主義
Underdog	超狗任務
Poseidon	海神號
Lars and the Real Girl	充氣娃娃之戀
Nurse 3D	3D血護士
Thirst	蝙蝠
The Killer Inside Me	魔由心生
The Disappearance of Eleanor Rigby	謎走愛情
Tideland	奇幻世界
The Darjeeling Limited	大吉嶺特快車
McFarland, USA 	衝刺終點線
A Bad Moms Christmas 	阿姐響叮噹
Letters from Iwo Jima 	來自硫磺島的信
Dirty Deeds	下流高校
Rust & Bone	鏽與骨
Hannah Montana The Movie	孟漢娜電影版
Spring Breakers	放浪春假
Branded	莫斯科2017
The Little Hours	色慾修道院
Pan's Labyrinth	迷宮
The Brothers Grimsby	特務大臨演
Serena	瞞天殺機
Twin Sisters 	烽火孿生淚
Firehouse Dog	我家也有消防狗
That Awkward Moment 	我們算正式交往嗎？
My Soul to Take	死期倒數24小時
Oliver Twist 	孤雛淚
Free Birds 	自由鳥
Bait 3D	誘鯊
Testament of Youth 	青春誓言
Jack the Giant Killer	傑克巨人戰記
The Vicious Kind 	惡劣的善意
It's Already Tomorrow in Hong Kong 	愛情無時差
All The King's Men	國王人馬
Spider-Man: Into the Spider-Verse	蜘蛛人:新宇宙
The Details	居家風暴
Leaves of Grass	雙子陰謀
Kung Fu Panda	功夫貓熊
Black Sheep 	黑綿羊
Plush	絨毛團
Grace of Monaco	摩納哥王妃
War Room	同室操戈
30 Days of Night	夜三十
Fugitive Pieces	心碎時光
Step Up 2 the Streets	舞法舞天2
Conversations with Other Women	與陌生女子調情
Dead And Breakfast 	誰敢來早餐
In the Mix	愛情混音師
Now You See Me: The Second Act	忍者龜2:出神入化2
The Amityville Horror 	陰宅
The Quiet Ones 	檔案
Puncture	針情法網
I Know Who Killed Me	雙面人質
Wolf Creek 2	鬼哭狼嚎2
The Chronicles of Narnia: Prince Caspian	納尼亞傳奇2
Beauty Shop 	哈啦美髮師
Ice Age: Collision Course 	冰原歷險記5
Voice from the Stone 	謎之陰
Sympathy for Lady Vengeance	選擇
Wonderstruck	奇光下的秘密
10 Items or Less	真情不打烊
The Hateful Eight 	八
Eagle vs. Shark	鯊魚愛老鷹
Hamlet 2	哈姆雷特2
Love	性本愛
Monster-in-Law	野獸婆婆
Mysterious Skin	神秘肌膚
The Adventures of Shark Boy and Lava Girl in 3-D	立體小奇兵
Finding Dory	海底總動員2
The Life Before Her Eyes	失序人生
Four Brothers	四虎出閘
The Night Before 	聖誕狂歡夜
Cinderella Man	最後一擊
No Good Deed 	惡煞臨門
The Space Between Us	我們之間的小宇宙
The Invention of Lying	謊言先師
The Great Debaters	雄辯天下
Stealing Cars 	竊車犯
The Collector	蒐藏人
Saw 2	奪魂鋸2
The Producers	金牌製作人
Hesher 	頑劣份子
Derailed	玩火
Keeping Up with the Joneses	間諜大鄰演
American Reunion	美國派:高潮再起
If I Want to Whistle, I Whistle 	如果我想吹口哨
Snakes on a Plane 	飛機上有蛇
The Squid and the Whale	烏賊與鯨
Black Sea 	黑海
Ride Along 2	一路靠北2
Pete's Dragon	尋龍傳說
Elegy	垂死的肉身
The World's End	末日
Divergent	分歧者2
Little Man	小孩好黑
9 Songs	性愛搖滾樂
I Love You, Beth Cooper	我愛你
Concussion	震盪
Fido	我家有個大屍兄
Hoodwinked	小紅帽
Doom	毀滅戰士
Ouija 2	碟仙2
The Cave	異底洞
Dylan Dog: Dead of Night	狄倫犬:惡夜偵探
Far from the Madding Crowd	遠離塵囂
The Tale of Despereaux	雙鼠記
Project X	派對X檔案
Smashed	醉生夢醒
Mad Hot Ballroom 	快樂舞年級
The Last Airbender	降世神通
Fast Food Nation	速食國度
Romulus, My Father	我的父親羅慕勒斯
Max	軍犬麥斯
Fateless	非關命運
Machuca	那年陽光燦爛
Pride and Glory	光榮戰警
You Kill Me	殺死我吧
Where the Truth Lies	真相何在
Viceroy's House 	亂世傷痕:末代總督的秘密
Holding Trevor 	誰來愛我
Mao's Last Dancer	毛的最後舞者
(500) Days of Summer	分手的那一天
In Her Shoes	偷穿高跟鞋
The Perfect Guy 	完美情狼
The Nut Job 	堅果任務
Dolphin Tale	重返海豚灣
The Big Year	賞鳥的一年
Freedom Writers	街頭日記
The World's Fastest Indian	超速先生
King Cobra 	眼鏡蛇男神
Superman Returns 	超人再
Failure to Launch	賴家王老五
Water	禍水
Aliens in the Attic	樓上鄰居外星人
GF。BF	女朋友男朋友
True Legend 	蘇乞兒
Immortals	戰神世紀
Glee: The 3D Concert Movie	歡樂合唱團3D
Foxcatcher	狐狸捕手
The Lookout	監守自盜
Breakfast on Pluto	冥王星早餐
Thor: The Dark World	雷神索爾2
Thank You for Your Service 	感謝您為國效力
Silent House	一噤到底美國版
The X Files 2	X檔案2
Fred Claus	聖誕
Layer Cake 	夾心蛋糕
John Carter	異星戰場
Aftershock	巨震過後
Imaginary Heroes	心碎天堂
The Legend of Zorro	蒙面俠蘇洛2
American Gangster	美國幫派
Zero Dark Thirty 	0501斬首密令
Red State	神愛弒人
The Ring Two	剎靈
Haven	染血天堂
Ghost House	鬼屋泰淒厲
Must Love Dogs	愛狗男人請來電
Flicka	真愛無韁
Cirque du Soleil: Worlds Away 3D	太陽馬戲團
The Soloist	心靈獨奏
Fences	籬笆內的風暴
The Dilemma	進退兩難
The Woman in Black: Angel of Death 	顫慄黑影2
Sherrybaby	雪莉寶貝
Steamboy 	氣男孩
Stephanie Daley	未婚媽媽
The Uninvited 	不請自來
Dear  Frankie	來信情緣
Jindabyne	湖濱疑雲
Clean	錯的多美麗
Rachel Getting Married 	瑞秋要出嫁
Jackass 2	蠢蛋搞怪秀2
The SpongeBob Movie: Sponge Out of Water	海綿寶寶2
Taxi to the Dark Side	計程車司機之死
Snow Cake	雪季過客
In the Heart of the Sea	白鯨傳奇
The Man with the Iron Fists	功夫鐵拳
The Good Night	夜夜成癮的男人
Dare	敢愛敢當
Night at the Museum	博物館驚魂夜
Redacted	波灣陰謀
The Good Doctor 	狼心仁術
You Will Meet a Tall Dark Stranger	命中注定遇見愛
Funny Games	大快人心
Writers	寫意人生
The Long Weekend 	哥哥我還要
Anchorman 2: The Legend Continues	銀幕大角頭2
In the Land of Women	左右逢緣
Humpday	G片初體驗
Martha Marcy May Marlene	迷懵夢寐
Alexandra	亞歷珊卓
Madagascar	馬達加斯加
Downfall 	帝國毀滅
Moon	月球漫遊
Stomp the Yard	獨步舞林
My Golden Days	追憶燦爛年華
The Dying Gaul	垂死的高盧人
Jeepers Creepers 3: Cathedral	毛骨悚然3
Apartment 143 	鬼寓143
Memories of Tomorrow	明日的記憶
Daltry Calhoun	草地上的男人
Truth	關鍵真相
The Secret Life of Bees	蜂蜜罐上的聖瑪利
Peter and Vandy	彼得與溫蒂之戀
No One Lives 	無人生還
Suffragette	女權之聲:無懼年代
Zoom	超人集中營
Zathura	迷走星球
Skinwalkers	異族終結戰
Joe	叢林法則
Tony Takitani 	東尼瀧谷
Proof	證明我愛你
3 Needles	帶原者之歌
Suburbicon	完美社區謀殺案
Dreamer: Inspired by a True Story	夢想奔馳
A History of Violence	暴力
Big Mommas: Like Father, Like Son	絕地奶霸3
Straw Dogs	惡鄰古堡
The Reluctant Fundamentalist 	拉合爾茶館的陌生人
H2	月光光心慌慌2
Deuce Bigalow: European Gigolo	哈啦猛男秀2
XXY	我是女生,也是男生
Prime	春心蕩漾
The Grand Budapest Hotel 	布達佩斯大飯店
Breaking & Entering	非法入侵
Nobody Knows 	無人知曉夏日清晨
The Beat That My Heart Skipped	我心遺忘的節奏
Paradise Lost	失樂園
Life	異星智慧
Paradise Now 	天堂此時
Cloud Atlas	雲圖
Hunger	飢餓
Predators	終極戰士3
Rise: Blood Hunter	血獵人
Jack Reacher 2	神隱任務2
The Pursuit of Happyness	當幸福來敲門
The Last King of Scotland	蘇格蘭之王
Time to Leave	愛無止期
Toni Erdmann 	顛父人生
The Night Listener	頻率
X-Men 3	X戰警3
Exodus: Gods and Kings	出埃及記
The Double	雙面諜
Justin Bieber: Never Say Never	小賈斯汀:挑戰不可能
Trade	走私人口
Elektra	幻影殺手
The Fast and the Furious: Tokyo Drift	玩命關頭3
Grizzly Man	灰熊人
Batman: The Killing Joke 	蝙蝠俠:致命玩笑
Bomb the System	轟炸街頭
Final Girl	前嫌盡弒
Flawless	天衣無縫
The Notorious Bettie Page	寫真女王
Get Hard	刑前教育
Fright Night	吸血鬼就在隔壁3D
Oldboy	老男孩
SiREN	妖物
I Don't Want to Sleep Alone 	黑眼圈
Aquamarine	美人魚之戀
Open Season	打獵季節
Thank You for Smoking	菸草之王
Bedtime Stories	天方夜
Whiskey Tango Foxtrot	戰地瘋雲
Poison Friends 	解構新鮮人
City of Ember 	微光城市
Palo Alto	高校寫真
Deadpool	死侍
The Amazing Spider-Man	蜘蛛人:驚奇再起
Sin City	萬惡城市
The Fog	鬼霧
Don't Come Knocking 	別來敲門
Kung Fu Hustle 	功夫
Welcome to the Punch 	重擊戒備
The Painted Veil	猜心
The Only Living Boy in New York	紐約唯一活著的男孩
Mirror Mirror	魔鏡魔鏡
Dumb and Dumber To	阿呆與阿瓜2
Locke	失速人生
King Kong	金剛
The Descent	深入絕地
Shorts	神通魔法石
Typhoon	颱風
Down in the Valley	愛在山谷下
9	9
RV	休旅任務
What We Do In The Shadows	吸血鬼家庭詩篇
The Hitchhiker's Guide to the Galaxy	星際大奇航
Last Vegas	賭城最後一夜
Robots	機器人歷險記
Katy Perry: Part of Me	凱蒂佩芮:做我自己
13 Tzameti	百萬殺人遊戲
88 Minutes	八十八分鐘
Departures	送行者
Tristan & Isolde	崔斯坦與依索德
Something New	心花漾
The Other Woman 	愛與親愛的
The Twilight Saga: Breaking Dawn - Part 1	暮光之城4:破曉I
Frozen River	急凍邊境
Borat	芭樂特
Year of the Dog	好運汪汪來
13	13搏命遊戲
Priceless	巴黎拜金女
Alvin and the Chipmunks: The Road Chip 	鼠來寶4
Free the Nipple 	Lady's尖頭們
A Most Wanted Man 	諜報風雲
Happy People: A Year in the Taiga	西伯利亞漂流
Once	吟遊戀人
Hostage	火線對峙
Everybody's Fine	天倫之旅
Crouching Tiger, Hidden Dragon: The Green Legend	臥虎藏龍2
The Informers	性謀殺天使城
The Twilight Saga: Eclipse	暮光之城3
The Return	回魂
Main Street	榮耀大道
The Ant Bully	聯合縮小兵
Million Dollar Arm 	金臂美國夢
Black Christmas	絕命聖誕
Sky Blue 	晴空戰士
The Young Victoria 	維多利亞女皇情史
The Brothers Grimm	神鬼剋星
Eastern Promises	巨塔殺機
House At The End of the Street	末路凶宅
Thumbsucker	吮指
Marebito	稀人
The Fourth Kind	第四類接觸
Madagascar 3: Europe's Most Wanted 	馬達加斯加3
Alien vs. Predator 2	異形戰場2
The Shaggy Dog	長毛狗
Priest	獵魔教士
Munich	慕尼黑
Peter Rabbit	得兔
The Strangers: Prey at Night	陌路狂殺2
Breach	雙面特工
Three Times	最好的時光
Charlotte's Web	夏綠蒂的網
The Best of Youth	燦爛時光
The World	世界
The Other Side of Hope	希望在世界另一端
A Long Way Down	往下跳
The Woman	女獸人
Infamous	柯波帝:冷血污名
The Rocker	搖滾青春夢
Fantastic Four	驚奇四超人
An Unfinished Life 	待續
Redline	熾色炫風
Tyler Perry's Madea's Family Reunion	家和萬事興
The Astronaut Farmer	太空農夫
Undiscovered	緣星夢
Blair Witch 	厄夜叢林3
Hitman: Agent 47	刺客任務
Garfield's A Tale of Two Kitties	加菲貓2
A Nightmare on Elm Street	半夜鬼上床
Curse of the Golden Flower	滿城盡帶黃金甲
Time	謊顏
Promised Land	心靈
Storks	送子鳥
The Family Stone 	婆家就是你家
Dheepan	流離者之歌
Cheaper by the Dozen 2	二十四笑
Broken Flowers	心碎排行榜
Are You Here	人生大逆轉
The Gospel 	福音總動員
Freaks of Nature	怪獸高中
Love and Honor	愛情逃兵
Sukiyaki Western Django 	日式牛仔一品鍋
Red Eye	赤眼玄機
Philomena	遲來的
Then She Found Me 	心的歸屬
The Amateurs	A片特攻隊
The Silence of Lorna  	沉默的羅娜
A Good Day to Die Hard	終極警探5
Revolver	玩命左輪
The Interpreter	雙面翻譯
Planes: Fire & Rescue	飛機總動員2
Pride 	同志驕傲大遊行
Keanu	基努賤隊
Final Girl	最後尖叫女王
Kontroll	地鐵迷宮
House	魔咒鬼屋
Sky High	超人高校
MirrorMask 	仙鏡奇緣
What Doesn't Kill You	好漢不死
Captain America: The Winter Soldier	美國隊長2
Interstellar	星際
Charlie and the Chocolate Factory	巧克力冒險工廠
Bucky Larson: Born to be a Star	天生男優
Chicken Little	四眼天雞
The Devil Wears Prada	穿著Prada的惡魔
Hanna	殺手漢娜
Rocky Balboa	洛基6
Jeff, Who Lives at Home	阿宅的二三事
Wrath of the Titans	超世紀封神榜2
The Queen	女王陛下
Balzac and the Little Chinese Seamstress	巴爾札克與小裁縫
Black Souls	教父啟示錄
The Nines	九度空間
Trust the Man	相信你的男人
MacGruber	百戰天蟲
Kicking & Screaming	踹球叫練
El Cantante	歌神
Dolphin Tale 2	溫特的故事2
Avengers: Age of Ultron 	復仇者聯盟2
活見鬼	活見鬼
My One and Only	世界唯一的你
Passion	激情
The Wild	野蠻任務
Love Is Strange 	愛,不散
Slender Man 	妖瘦男
White Noise 	鬼訊號
Mississippi Grind 	賭國大丈夫
Dallas 362 	達拉斯362
The Russian Dolls	西班牙公寓2
Reno 911!: Miami	邁阿密瘋雲
The U.S. vs. John Lennon	美國vs.約翰藍儂
Just Like Heaven	出竅情人
Solitary Man	孤單男人
Goal! The Dream Begins 	疾風禁區
Valiant	鴿戰
Alone in the Dark	異形鬼屋
1911	1911辛亥革命
The Hobbit: An Unexpected Journey	哈比人
Vehicle 19	玩命車手
I Origins 	人之初
Saint Ralph	神奇馬拉松
Begin Again	曾經,樂是唯一
I Hope They Serve Beer in Hell	塔克,嘿咻嘿咻嘿咻!
Georgia Rule	情規喬治亞
Joshua	魔鬼約書亞
I Love You, Man	麻吉伴郎
Run the Tide 	逐浪而生
Three...Extremes 	三更2
Flash of Genius	智慧戰爭
The Best of Me	有你,生命最完整
Southland Tales	南國傳奇
Klown	丑男大丈夫
No Regret 	愛無悔
My Summer of Love 	我的夏日戀曲
Mongol	蒙古王
Hidden	隱藏攝影機
Misconduct	魔鬼總裁
Transamerica	窈窕老爸
Wild Side	狂野三人行
Rush Hour 3	尖峰時刻3
Are We Done Yet?	有完沒完
Europa Report 	歐羅巴報告
John Rabe 	拉貝日記
Ice Age: Continental Drift	冰原歷險記4
Disaster Movie	終極災難電影
Brothers	變奏曲
V For Vendetta	V怪客
Miracle at St. Anna	聖安娜奇蹟
The Book of Eli	永生書
Looking for Comedy in the Muslim World	笑翻清真寺
Monte Carlo	愛在蒙地卡羅
XXX: State of the Union	限制級戰警2
Wallace & Gromit - The Curse of the Were-Rabbit	酷狗寶貝
Shrooms	死神魔菇
The Giver	記憶傳承人
The Odd Life of Timothy Green	小芽的奇幻人生
Legend of the Fist: The Return of Chen Zhen	陳真:精武風雲
A Taxi Driver	我只是個計程車司機
Pirates of the Caribbean: On Stranger Tides	神鬼奇航4
Men, Women & Children	雲端男女
Footloose	渾身是勁2011
Tim Burton's Corpse Bride	地獄新娘
Arthur Christmas	聖誕快遞
Anonymous	莎士比亞的秘密
5x2 	5X2愛情賞味期
I Am Michael 	麥可—我的直男前男友
The Jacket	戰慄時空
Vita Activa: The Spirit of Hannah Arendt	漢娜鄂蘭─思想的行動
Intruders	入侵者
24 Hours to Live	24小時殺到爆
Imagine Me & You	新娘向後跑
The Matador	肝膽相照
Same Kind of Different as Me	紳士與流浪漢
My Brother Is An Only Child	我的左派哥哥
The Mysteries of Pittsburgh	匹茲堡的秘密
Life of Pi	少年Pi的奇幻漂流
Heights 	愛在紐約破曉時
Blackhat	黑帽
Good Kill 	狙擊手
Star Wars: Episode III - Revenge of the Sith 	星際大戰第三部曲
Irina Palm 	洞裡春光
Texas Killing Fields	德州棄屍現場
The Loft	偷情閣樓
Paul Blart: Mall Cop	百貨戰警
Shelter	避風港
Loverboy	溺愛
The New World	決戰新世界
Off the Map 	世界盡頭
Over Her Dead Body 	我男友的死未婚妻
Prince of Persia: The Sands of Time	波斯王子
Factotum	醉快活
Simon Killer 	巴黎自由行
Ceremony	劫婚典禮
Or 	後街天使
Parental Guidance	祖父母囧很大
The Vatican Tapes 	梵諦岡影帶
Before I Wake 	撕眠
Silent Hill	沉默之丘
Don't Tell	誘禍
The Act of Killing 	殺人一舉
The Goods: Live Hard. Sell Hard.	王牌推銷員
Captivity	窒命寫真
Standing Still	明天也要作伴
3-Iron 	空屋情人
5 Days Of War 	五日戰爭
Miami Vice	邁阿密風雲
Three	3人擠不擠
Barnyard	瘋狂農莊
Enchanted	曼哈頓奇緣
Random Tropical Paradise 	蜜月玩很大
Batman v Superman: Dawn of Justice	蝙蝠俠對超人
Bobby	五星級謀殺
Mission: Impossible Ghost Protocol	不可能的任務4
Goal! 2: Living the Dream... 	疾風禁區2
Another Gay Movie 	酷兒狂歡派
Bee Season	蜂王季
One Last Thing...	最後的願望
Hail, Caesar!	凱薩萬歲
The Hunting Party	腥聞
Innocent Voices 	純真的聲音
600 Millas 	命懸六百哩
Supercross	越野狂飆
Factory Girl	明星夢工廠
Cirque Du Freak: The Vampire's Assistant	鬼不理的助手
Shooting Dogs 	殺戮禁區
The Warrior's Way	黃沙武士
Pride and Prejudice	傲慢與偏見
Valkyrie	代號:華爾奇麗亞
Me and You and Everyone We Know 	愛情你我她
Youth Without Youth	時光逆侶
We Bought a Zoo	我們買下了動物園
X-Men Origins: Wolverine	X戰警:金鋼狼
The Game of Their Lives	贏向一生的挑戰
The Guilt Trip	虎媽宅子
Son of the Mask	小鬼也摩登
Postal	喋血街頭
Friends with Kids 	非婚生子
Appaloosa	鐵腕豪情
Baahubali: The Beginning	帝國戰神
A Lot Like Love	再見鍾情
Mister lonely	當麥克先生遇見夢露小姐…
Mindhunters	8面埋伏
The Divide	末日碉堡
Match Point	愛情決勝點
Monster House	怪怪屋
The Upside of Anger	愛你愛到快抓狂
Good Night. And, Good Luck	晚安!祝你好運
Assault on Precinct 13 	殲滅十三區
Ingrid Goes West 	網美嬉遊記
Magic Magic 	荒島魔咒
Crazy Heart	瘋狂之心
Romeo and Juliet 	羅密歐與茱麗葉
Man of the House	啦妹當家
Lassie	靈犬萊西
Sully	薩利機長
Old Joy	舊夢
Asylum	愛慾癡狂
Bewitched	神仙家庭
Entourage	我家也有大明星
Paranormal Activity: The Marked Ones	鬼入鏡:詛咒
Batman Begins 	蝙蝠俠:開戰時刻
Music Within	樂自心中來
Sex Drive	性愛之旅
The Holiday	戀愛沒有假期
Because of Winn-Dixie	多虧有你
Basic Instinct 2: Risk Addiction	第六感追緝令2
The Road 	往生路
Abraham Lincoln: Vampire Hunter	吸血鬼獵人
Bad Grandpa 	無厘取鬧:阿公壞壞
Remember Me	記得我
All Good Things	好景不常
Streets of Legend	黑街神話
Hotel for Dogs	狗狗旅館
Bratz	閃亮小天后
The Company You Keep 	夥伴
Miss March	三月封面女郎
Diminished Capacity	往事隨風
Pompeii	龐貝:最後之日
Take the Lead	獨領風潮
All is Lost 	遺落汪洋
Enron: The Smartest Guys in the Room	安隆風暴
Wind Chill	斷魂谷
Fifty Shades of Black 	雷的五十道黑影
The Pacifier	限制級褓母
Trainwreck	肉食女之戀
Deck the Halls	裝璜東西軍
Café Society 	咖啡愛情
How to Eat Fried Worms	活蟲生吃
Star Trek Sequel	星際爭霸戰2
The Black Dahlia	黑色大理花懸案
12	12怒漢:大審叛
The Protector	拳霸2
Magic in the Moonlight	月光魔法
Muppets Most Wanted	布偶歷險記2
The Mortal Instruments: City of Bones	骸骨之城
High Tension	顫慄
Camp X-Ray 	關塔那摩X光營
Golden Compass	黃金羅盤
Trust	迷網女孩
Winter Solstice	冬至
Some Freaks 	怪怪惹人愛
Slow West 	槍響前決定愛不愛你
Material Girls	拜金女孩
Rocket Science	一飛沖天
Next	下一秒
The Brothers Solomon	情聖兄弟
The Chumscrubber 	我行我素
MindGamers	腦波遊戲
Rent 	吉屋出租
Taxi	計程人生
Wild	那時候,我只剩下勇敢
Skateland	滑輪風暴
Easy Virtue	水性楊花
A Good Woman	美麗誘惑
Bel Ami	美男子
The Final Season	最後的球季
The Beautiful Country	美麗新故鄉
Grbavica	旅行之歌
The Good Shepherd	特務風雲
The Fantastic Mr. Fox	超級狐狸先生
Maniac 	剝頭煞星
Angry Birds	憤怒鳥
The Hunger Games: Mockingjay - Part 2	飢餓遊戲3.2
Gone Baby Gone	失蹤人口
People Like Us	親情可貴
Flightplan	空中危機
Suicide Squad	自殺突擊隊
Happily N'Ever After 	從此沒有過著幸福快樂的日子
Duck Season	友情電力公司
Running With Scissors	剪刀邊緣
The Sisterhood of the Traveling Pants 2	牛仔褲的夏天2
The Hitcher	幽靈終結者
Akeelah and the Bee	拼出新世界
The Kings of Summer	夏日之王
George A. Romero's Land of the Dead	活屍禁區
Smile 	笑逐顏開
Billy Lynn’s Long Halftime walk	比利林恩的中場戰事
Case 39	39特案
Bernie	胖尼殺很大
Melinda and Melinda 	雙面瑪琳達
Goodbye Christopher Robin	再見羅賓
Margaret	瑪格麗特
Enough Said 	愛在不言中
Big Ass Spider	屁王蜘蛛
The Hobbit: The Desolation of Smaug 	哈比人2
A Guide to Recognizing Your Saints	放下屠刀
Mini's First Time	蜜妮初體驗
Paprika	盜夢偵探
Red 2	超危險特工2
Cut Sleeve Boys	我愛斷背衫
I'll Follow You Down 	時空效應
The Amazing Spider-Man 2	蜘蛛人
12 Rounds	血戰12輪
Mr. and Mrs. Smith	史密斯任務
Stand Up Guys	重振雄風
Dom Hemingway	海明威好賊
One Direction: This Is Us	1世代
Shoot 'Em Up	火線保鑣
Margot at the Wedding	婚禮的祝福
Saw III	奪魂鋸3
Look at Me 	看看我聽聽我
Transsiberian	亡命西伯利亞
Paddington 2	柏靈頓2:熊熊出任務
The Spectacular Now 	戀夏進行式
Starship Troopers: Traitor of Mars	星艦戰將:火星叛徒
Boogeyman	惡靈空間
One Missed Call 	鬼來電西洋篇
Millions	百萬小富翁
P.S. I Love You	PS.我愛
Kumiko, the Treasure Hunter	久美子的奇異旅程
Fun with Dick and Jane	我愛上流
Lincoln	林肯傳
The Skeleton Twins 	人生雙告急
Beloved Sisters	狂愛姊妹花
The Paperboy	臨時派報員
Ten Thousand Saints 	輕狂時代
Saving Face	面子
The Witch 	巫氣逼人
Slither	撕裂人
Renaissance	黑暗文藝復興
The Frozen Ground	冰封之地
Deep Blue 	海底世界
Silent Hill: Revelation 3D 	沉默之丘2
Guess Who	誰敢來晚餐
Train to Busan	屍速列車
Diary of a Mad Black Woman	瘋婆娘日記
For Your Consideration	問鼎奧斯卡
Beautiful Boxer 	美麗拳王
Surveillance	監視
Mistress America 	美國小三
9/11	911絕命電梯
Skyfall	007空降危機
Be Cool	黑道比酷
Mud	阿泥正傳
Ong-Bak: The Thai Warrior 	拳霸
The Overnight	越夜越狂
Big Momma's House 2	絕地奶霸2
Cursed	魔咒
The Hunger Games: Catching Fire 	飢餓遊戲2
Two Night Stand 	暴雪二夜情
Howl's Moving Castle 	霍爾的移動城堡
The Lady	翁山蘇姬
The Abandoned	廢墟
Machine Gun Preacher	機關槍傳教士
An Inconvenient Truth	不願面對的真相
Love the Coopers	聖誕好家在
Home of the Brave 	勇士之家
Dark Water	鬼水
Perfume: The Story of a Murderer 	香水
Five Minutes of Heaven	天堂五分鐘
August Rush	貝伍夫:把愛找回來
The Secret of Kells	凱爾斯的秘密
Standing Tall	烈焰青春
Memoirs of a Geisha 	藝妓回憶錄
The Exorcism of Emily Rose	驅魔
Constantine	驅魔神探
The Faith of Anna Waters	安娜華特
Happy-Go-Lucky	樂觀以對
Fur	皮相獵人
Crossing Over	嫁禍手段
The Wind That Shakes the Barley	吹動大麥的風
A Very Harold & Kumar Christmas 	豬頭漢堡飽3D
The Sisterhood of the Traveling Pants 	牛仔褲的夏天
Rampart	壁壘分局
Coach Carter	卡特教頭
Godzilla Resurgence 	正宗哥吉拉
Flyboys	空戰英豪
Indigènes	光榮歲月
Seediq Bale	賽德克巴萊
Mamma Mia! Here We Go Again 	媽媽咪呀2
Boy A	頭號男孩
The Counterfeiters 	偽幣製造者
Kiss Kiss, Bang Bang	吻兩下打兩槍
Obsessed	鬼迷心竅
Miss Congeniality 2: Armed and Fabulous	麻辣女王2
The Wedding Date	嫁期
Johnny English Reborn 	凸搥特派員2
Bad News Bears	小熊出擊
Ladies in Lavender	薰衣草夫人
Mail Order Wife 	伊媚兒新娘
Scary Movie 4	驚聲尖笑4
Encounters at the End of the World 	冰旅記事
The Boss 	甜心大姐頭
Courageous	勇氣之名
Crash	衝擊效應
The Haunting in Connecticut 2: Ghosts of Georgia	康乃狄克鬼屋事件2
How I Live Now 	我的生存之道
Swimming Upstream 	泳往直前
Exiled 	放逐
Nothing But the Truth	捍衛真相
High-Rise 	摩天樓
Burning Blue 	烈火擎天
Everybody Wants to Be Italian	義國戀
Trick 'r Treat 	不給糖就殺人
Pirates of the Caribbean: Dead Man's Chest	神鬼奇航2
The Promotion	職場爭霸戰
The Lost City	遺忘故都
The Best Man Holiday 	哈拉婚禮2
My Life in Ruins	旅行的意義
I'm Still Here	我仍在這裡
Off the Black	賠我走這一程
Red Tails	熾天之翼
Megamind	麥克邁:超能壞蛋
The Departed	神鬼無間
X-Men: First Class	X戰警:第一課
Upside Down	顛倒世界
Transporter 2	玩命快遞2
Bandidas	神鬼二勢力
Win Win	幸福雙贏
A Fantastic Woman	不思議女人
Cronicas	深入虎穴
Death Wish	猛龍怪客
Tamara	魔女煞
Think Like a Man	男人的上半身去哪了
Dirty	汙點
Racing Stripes	斑馬快跑
Everything Must Go	一無所有
Last Holiday	假期
The Chronicles of Narnia: The Lion, The Witch and The Wardrobe 	納尼亞傳奇
The Longest Yard	鐵男橄欖球
The Cave Of The Yellow Dog 	小黃狗的窩
Sicko	健保真要命
Election 2	黑社會2
Sydney White	白雪新鮮人
The Promise	無極
Poltergeist	鬼哭神嚎
Mr. Turner	透納先生
Waiting	哈啦上菜
The Science of Sleep	潛意識夢遊
Marilyn Hotchkiss' Ballroom Dancing and Charm School	舞動心方向
Away From Her	妳的樣子
The Year of the Yao 	姚明來了
The Island	絕地再生
ParaNorman	派拉諾曼:靈動小子
Kubo and the Two Strings	酷寶:魔弦傳說
Passengers	星際過客
The Divergent Series: Allegiant 	赤誠者
Weirdsville	怪胎鎮
The Hottest State	最炎熱的州
Resident Evil: Retribution	惡靈古堡5
For a Good Time, Call...	高潮專線
Herbie: Fully Loaded	金龜車賀比
Primeval	萬鱷巨獸
Cyrus	拖油瓶
W.	請問布希大人
War of the Worlds	世界大戰
Imagine That	天才神算
Van Wilder 2: The Rise of Taj	凸種高材生2
Midnight in Paris	午夜巴黎
Oldboy 	原罪犯美國版
The Road to Guantanamo	通往關達那摩之路
Cashback	超級賣場
The Skeleton Key	毒鑰
Alex Cross	絕命追緝令
The Good Guy 	曼哈頓
School for Scoundrels	無賴速成班
T2: Trainspotting	猜火車2
Blood Diamond	血鑽石
Tinker, Tailor, Soldier, Spy	諜影行動
Kingdom of Heaven	天者天下
Battle of the Year	世界Battle
I Saw the Light	音樂之光
Central Intelligence 	中央情報局
Golden Door	金色大門
Time Renegades	時光叛逃者
The Ex	舊情人
Murderball	謀殺球
Kindergarten Cop 2	魔鬼孩子王2
All I See Is You	盲女驚心
The Ballad of Jack and Rose 	傑克與羅絲的民謠
A Sound of Thunder	雷霆萬鈞
Filth	下流刑警
Ask the Dust	心塵情緣
Good Time	失速夜狂奔
Dark Skies	幽浮檔案
Gambit	金牌手
The Raven	愛倫坡懸案
Love in the Time of Cholera	愛在瘟疫蔓延時
Unknown	玩命記憶
Wedding Crashers	婚禮終結者
Unleashed	寵物情人
Bachelorette	單身女郎派對
Soul Men	靈魂樂手
Lady in the Water	水中的女人
All About Steve	求愛女王
Youth in Revolt	青春轉大人
Tammy	阿美闖天涯
Wall Street: Money Never Sleeps	華爾街2
Swiss Army Man 	屍控奇幻旅程
Death at a Funeral	超完美告別
The To Do List 	大學生做了沒
Early Man 	石器小英雄
Collide	玩命撞擊
Adam	亞當不好當
Brokeback Mountain 	斷背山
We Need to Talk About Kevin	凱文怎麼了？
The East	東方聯盟
Firewall	防火牆
Hoodwinked Too! Hood vs. Evil	Kuso小紅帽2
The Nativity Story	降世錄
Happy Feet	快樂腳
City of Men	無法無天2
Cats & Dogs: The Revenge of Kitty Galore	貓狗大戰2
To the Wonder	愛•穹蒼
The Last Winter	歿日冰封
Out of the Furnace	逃出熔爐
I, Frankenstein 	科學怪人
Loving Vincent 	梵谷:星夜之謎
Maleficent	黑魔女:沉睡魔咒
Yes 	黎巴嫩情人
Heaven Is for Real 	看見天堂
Invincible	所向披靡
Talk to Me	誰來叩應
Bite	X戰警:變蟲人
The Raid 2: Berandal 	全面突襲2
Timecrimes	時間殺人
Kingsglaive: Final Fantasy XV	王者之劍:太空戰士15電影版
Man of the Year	風雲人物
The Lake House 	跳越時空的情書
To Rome with Love 	愛在羅馬
Nanny McPhee	魔法褓母麥克菲
Soul Surfer	靈魂衝浪
Ma Mere	母親,愛情的限度
127 Hours	求生127小時
The Legend of Tarzan	泰山傳奇
Mars Needs Moms	火星救母記
The Santa Clause 3	聖誕快樂又瘋狂3
Ice Princess	冰公主
The Huntsman Winter’s War	狩獵者:凜冬之戰
Blood and Chocolate	血腥巧克力
Five Star Day	占星奇緣
Rabbit Hole	愛,讓悲傷終結
Kung Fu Panda 3	功夫熊貓3
Blind Dating	盲目約會
Hide and Seek	捉迷藏
In the Shadow of the Moon	月球暗面
The Celestine Prophecy	聖境預言書
The November Man 	諜海無間
World Trade Center	世貿中心
August	八月錢潮
This Film is Not Yet Rated	本片尚未分級
Kill Your Darlings	殺死達令
The Oh in Ohio	俄亥俄的哦
Stardust	星塵情緣
Captain America 3: Civil War 	美國隊長3
Blades of Glory	冰刀雙人組
Moneyball	魔球
BloodRayne	吸血萊恩
Street Fighter: The Legend of Chun-Li	春麗傳奇
Our Brand Is Crisis 	危機
The Stone Angel	天使石像
Before the Fall	英雄教育
Is Anybody There?	有人在家嗎?
Modigliani 	燃情狂愛
Chaos 	虐殺
Rudo y Cursi	圓夢旅程
13 Hours: The Secret Soldiers of Benghazi 	13小時
Get Rich or Die Tryin'	要錢不要命
[Rec] 2	屍控
The Libertine	風流才子
Kit Kittredge: An American Girl	奇特女孩
Hitch	全民情聖
Precious Cargo	終極
Forever Strong	奮戰不懈
Shrek Forever After	史瑞克四
The Stepfather 	繼父疼死你
The Child	孩子
Somersault 	我行我愛
American Honey 	2016美國甜心
Happy Endings	快樂結局
On a Clear Day	澄澈的一天
Journey 2: The Mysterious Island	地心冒險2
The Hills Have Eyes	山
Venus	維納斯
The Layover 	獵男有轉機
The Maze Runner: The Scorch Trials 	移動迷宮2:焦土試煉
Cheri	嫩男謝利
Piranha 3DD 	3DD食人魚
Sin City: A Dame to Kill For	萬惡城市2
Unleashed	鬪犬
Resurrecting the Champ	重振聲威
Prom	畢業舞會
Mrs. Henderson Presents	裸體舞台
Beastly	夢魘情人
Cars 2	汽車總動員2
The Oxford Murders 	牛津殺人魔
