哈啦十誡	The Ten
同志驕傲大遊行	Pride 
天才的禮物	Gifted
下一秒就是你	You're Next 
G片初體驗	Humpday
亞當不好當	Adam
天才柏金斯	Genius
八	The Hateful Eight 
最後的願望	One Last Thing...
燃情狂愛	Modigliani 
肉食女之戀	Trainwreck
愛情決勝點	Match Point
安妮	Annie
健保真要命	Sicko
完美情狼	The Perfect Guy 
尋找快樂的15種方法	Hector and the search for happiness
玩火	Derailed
可可夜總會	Coco
八月三十一日,我在奧斯陸	Oslo, 31. august 
寫真女王	The Notorious Bettie Page
狙擊生死線	Shooter
情規喬治亞	Georgia Rule
教父啟示錄	Black Souls
愛狗男人請來電	Must Love Dogs
鼠來寶	Alvin and the Chipmunks
福爾摩斯先生	Mr. Holmes 
白雪新鮮人	Sydney White
風雲男人幫	Gangster Squad 
食破天驚2	Cloudy With a Chance of Meatballs 2
幸福雙贏	Win Win
神鬼傳奇3	The Mummy: Tomb of the Dragon Emperor
澄澈的一天	On a Clear Day
德州棄屍現場	Texas Killing Fields
職場爭霸戰	The Promotion
性本惡	Inherent Vice 
環太平洋2	Pacific Rim: Uprising 
即刻獵殺	The Grey
鷹眼	Eagle Eye
內布拉斯加	Nebraska
海狸先生	The Beaver
野蠻任務	The Wild
狗狗旅館	Hotel for Dogs
40處男	The 40-Year-Old Virgin
雜交有益身心	A Good Old Fashioned Orgy
給雅各神父的信	Letters to Father Jacob
惱爸偏頭痛	Why Him?
八月錢潮	August
戰爭機器	War Machine 
最後大法師2	The Last Exorcism Part II
二十四笑	Cheaper by the Dozen 2
那年陽光燦爛	Machuca
浪蕩世代	On the Road
幽浮檔案	Dark Skies
樂高玩電影	The LEGO Movie 
寶島雙雄	Double Trouble
莫斯科2017	Branded
忠犬追殺令	White God
末日	The World's End
出棋制勝	Pawn Sacrifice 
蜘蛛人:驚奇再起	The Amazing Spider-Man
碟仙	Ouija
黎巴嫩情人	Yes 
雲圖	Cloud Atlas
美國心風暴	American Pastoral
惡靈古堡4	Resident Evil: Afterlife
慕尼黑	Munich
得兔	Peter Rabbit
憤怒鳥	Angry Birds
薄暮之光	Lights in the Dusk 
異底洞	The Cave
舞力全開3D	Step Up 3D
不給糖就殺人	Trick 'r Treat 
進擊的大佬	Grudge Match
移動迷宮3	Maze Runner: The Death Cure
哈姆雷特2	Hamlet 2
毒鑰	The Skeleton Key
哈啦美髮師	Beauty Shop 
玩命撞擊	Collide
在屋頂上流浪	Mister Foe 
絞刑台	The Gallows 
第四類接觸	The Fourth Kind
犬之島	Isle of Dogs
世界Battle	Battle of the Year
永生樹	The Tree of Life
友情電力公司	Duck Season
小鬼上路	Are We There Yet?
好漢不死	What Doesn't Kill You
聖誕夜怪譚	Disney's A Christmas Carol 
毛骨悚然3	Jeepers Creepers 3: Cathedral
金剛戰士	Power Rangers
不可能的任務3	Mission: Impossible 3
芭蕾奇緣	Ballerina
腥聞	The Hunting Party
敗者為王	The Losers
放下屠刀	A Guide to Recognizing Your Saints
宿主	The Host
推倒白宮的男人	Mark Felt: The Man Who Brought Down the White House
搖滾未來	Bandslam
私人採購	Personal Shopper 
安隆風暴	Enron: The Smartest Guys in the Room
永不屈服	Unbroken
鐵男橄欖球	The Longest Yard
控制遊戲	Return to Sender
真相何在	Where the Truth Lies
小鬼大間諜4	Spy Kids: All the Time in the World
13小時	13 Hours: The Secret Soldiers of Benghazi 
超世紀封神榜2	Wrath of the Titans
特殊身份	Special ID
顫慄黑影2	The Woman in Black: Angel of Death 
青蜂俠	The Green Hornet
窒命寫真	Captivity
超級賣場	Cashback
冰公主	Ice Princess
巴黎愛情故事	Paris
移動迷宮2:焦土試煉	The Maze Runner: The Scorch Trials 
黑紀元	The Dark Is Rising
我要為你呼吸	Breathe
惡靈古堡6	Resident Evil: The Final Chapter
愛在瘟疫蔓延時	Love in the Time of Cholera
活見鬼	活見鬼
攻其不備	The Blind Side
奇蹟男孩	Wonder 
剪刀邊緣	Running With Scissors
金錢怪獸	Money Monster
大學生殺了沒	Tucker & Dale vs. Evil
紐約我愛你	New York, I Love You
搖滾青春夢	The Rocker
蒐藏人	The Collector
搖滾青春戀習曲	Sing Street 
歌舞青春3	High School Musical 3: Senior Year
過於寂靜的喧囂	The Tribe
決勝21點	21
阿拉斯加之死	Into the Wild 
飛機總動員	Planes
飢餓遊戲2	The Hunger Games: Catching Fire 
紅雀	Red Sparrow
下流刑警	Filth
空中救援	Non-Stop 
愛謎藏	Little White Lies 
金牌拳手	Creed
暴雪二夜情	Two Night Stand 
名揚四海	Fame
明天也要作伴	Standing Still
絕美之城	The Great Beauty
豬頭漢堡飽3D	A Very Harold & Kumar Christmas 
玩命快遞2	Transporter 2
火線保鑣	Shoot 'Em Up
要錢不要命	Get Rich or Die Tryin'
神鬼無間	The Departed
孟漢娜電影版	Hannah Montana The Movie
狼人鎮	Wolves
俄亥俄的哦	The Oh in Ohio
溫徹斯特鬼屋	Winchester 
拼出新世界	Akeelah and the Bee
世界是平的	Outsourced
功夫熊貓2	Kung Fu Panda 2
黑天鵝	Black Swan
誘惑醫生100招	The Grand Seduction
福爾摩斯2	Sherlock Holmes 2
史瑞克三世	Shrek the Third
東方聯盟	The East
恐佈蠟像館	House of Wax
巴黎自由行	Simon Killer 
邁阿密瘋雲	Reno 911!: Miami
鬼寓143	Apartment 143 
針孔旅社	Vacancy
公主與狩獵者	Snow White and the Huntsman
婆家就是你家	The Family Stone 
獵人遊戲	Eden Lake
風暴過後	Into the Fire 
巫氣逼人	The Witch 
衝擊效應	Crash
羊男的冰島冒險	Rams
冰原歷險記5	Ice Age: Collision Course 
夏日之王	The Kings of Summer
忍者龜	Ninja Turtles
南方野獸樂園	Beasts of the Southern Wild
女王陛下	The Queen
神奇馬拉松	Saint Ralph
聖誕	Fred Claus
溫心港灣	Le Havre
孟漢娜3D演唱會	Hannah Montana & Miley Cyrus: Best of Both Worlds Concert Tour
星際過客	Passengers
極速秒殺	The Mechanic
雷神索爾3	Thor: Ragnarok 
A片特攻隊	The Amateurs
極樂世界	Elysium
國家寶藏2	National Treasure 2
1408	1408
五星級謀殺	Bobby
玩具總動員3	Toy Story 3
家有兩個爸2	Daddy's Home 2
心碎天堂	Imaginary Heroes
捍衛聯盟	Rise of the Guardians 
X戰警:未來昔日	X戰警: 未來昔日
槍響前決定愛不愛你	Slow West 
夥伴	The Company You Keep 
畢業舞會	Prom
王者之劍3D	Conan the Barbarian
東尼瀧谷	Tony Takitani 
快樂腳2	Happy Feet Two
以你的名字呼喚我	Call Me by Your Name 
活個痛快	50/50
1911辛亥革命	1911
草地上的男人	Daltry Calhoun
我唾棄你的墳墓	I Spit on Your Grave 
美麗新故鄉	The Beautiful Country
未來小子	Meet the Robinsons
朱比特崛起	Jupiter Ascending 
我記得	Remember
末日預言	Knowing
頭號男孩	Boy A
0501斬首密令	Zero Dark Thirty 
絕命賭局	Cheap Thrills
魔鬼剋星	Ghostbusters
待續	An Unfinished Life 
歌喉讚2	Pitch Perfect 2 
葉問2	Ip Man 2
小芽的奇幻人生	The Odd Life of Timothy Green
大快人心	Funny Games
最美的安排	Collateral Beauty
心靈	Promised Land
光靈	Bright
血腥巧克力	Blood and Chocolate
洞裡春光	Irina Palm 
魔詭	Morgan
唱快人生	Quartet
顛覆瘋雲	What Just Happened?
非法入侵	Breaking & Entering
愛在蒙地卡羅	Monte Carlo
雙面法蘭茲	Frantz
來自硫磺島的信	Letters from Iwo Jima 
功夫	Kung Fu Hustle 
烈火邊境	Free State of Jones
性愛成癮的女人	Nymphomaniac
末日列車	Snowpiercer
怪奇孤兒院	Miss Peregrine's Home for Peculiar Children
虎媽宅子	The Guilt Trip
廢柴特務	American Ultra 
時尚女王香奈兒	Coco Before Chanel
不願面對的真相2	An Inconvenient Sequel: Truth to Power 
超速先生	The World's Fastest Indian
世界大對戰	Pixels
性愛之旅	Sex Drive
星際	Interstellar
魔球	Moneyball
萬惡城市	Sin City
鬼鏡西洋版	Mirrors
切	Che
帶原者之歌	3 Needles
搖滾不靠爸	Len and Company 
明日世界	Tomorrowland
異星戰場	John Carter
哥哥我還要	The Long Weekend 
福音總動員	The Gospel 
德州電鋸殺人狂3D	Texas Chainsaw Massacre 3D
小小兵	Minions
我男友的死未婚妻	Over Her Dead Body 
潛水鐘與蝴蝶	The Diving Bell and the Butterfly
當我們混在一起	Blended
45年	45 Years
歡迎光臨奇幻城堡	The Florida Project 
迷幻公園	Paranoid Park
高潮專線	For a Good Time, Call...
抉擇	The Choice
零日網路戰	Zero Days
飛機上有蛇	Snakes on a Plane 
神鬼認證5	Bourne 5
看見天堂	Heaven Is for Real 
人生大逆轉	Are You Here
愛情盛宴	Feast of Love
國定殺戮日3	The Purge: Election Year
魔鬼終結者4	Terminator Salvation
絕命聖誕	Black Christmas
刺客公敵	Killers
芭樂特	Borat
噤界	A Quiet Place 
男人的上半身去哪了	Think Like a Man
黑書	Black Book 
謎之陰	Voice from the Stone 
溺愛	Loverboy
我愛上流	Fun with Dick and Jane
阿美闖天涯	Tammy
親情可貴	People Like Us
冥王星早餐	Breakfast on Pluto
魔女煞	Tamara
魔獸戰場	Outlander
巴黎走音天后	Marguerite
哈比人	The Hobbit: An Unexpected Journey
時空永恆的愛戀	The Age of Adaline 
十二月的男孩	December Boys
太空農夫	The Astronaut Farmer
浴血任務2	The Expendables 2
敦克爾克大行動	Dunkirk
心靈勇者	The Railway Man
亞歷山大衰到家	Alexander and the Terrible, Horrible, No Good, Very Bad Day 
瞎趴姊妹	Sisters
霹靂鳥探	Code Name: The Cleaner
霓虹惡魔	The Neon Demon
薩爾加多的凝視	The Salt of the Earth 
海洋奇緣	Moana
美國vs.約翰藍儂	The U.S. vs. John Lennon
熊愛趴趴走	Paddington
海綿寶寶2	The SpongeBob Movie: Sponge Out of Water
龍虎少年隊	21 Jump Street
人間師格	Detachment
錄到鬼3	[REC] 3: Genesis
顫慄	High Tension
最後一擊	Cinderella Man
神鬼二勢力	Bandidas
她和她的小鬼們	Short Term 12 
我們之間的小宇宙	The Space Between Us
震撼殺戮	Sabotage
天使石像	The Stone Angel
成人世界	Chappie
酷兒狂歡派	Another Gay Movie 
中間人	Middle Men
禍水	Water
關鍵琴聲	Grand Piano 
籬笆內的風暴	Fences
醉生夢醒	Smashed
沉默的羅娜	The Silence of Lorna  
里約大冒險2	Rio 2
X戰警:第一課	X-Men: First Class
分歧者2	Divergent
崖上的波妞	Ponyo on the Cliff 
底特律	Detroit
勇氣之名	Courageous
我家有個大屍兄	Fido
傑羅德遊戲	Gerald's Game
翻聲吧保羅	One Chance
石器小英雄	Early Man 
伴娘幫幫忙	Bridesmaids
忌日快樂	Happy Death Day
再見了,拉札老師	Monsieur Lazhar
愛重奏	Reprise
占星奇緣	Five Star Day
今晚帶我回家	Take Me Home Tonight
母親!	Mother!
家和萬事興	Tyler Perry's Madea's Family Reunion
大尋寶家	The Monuments Men 
夏日鴞鳴	Hoot
記得我	Remember Me
奪魂鋸4	Saw IV
海底總動員2	Finding Dory
性愛巴士	Shortbus
世界大戰	War of the Worlds
星光雲寂	Clouds of Sils Maria
戰地瘋雲	Whiskey Tango Foxtrot
染血天堂	Haven
康提基號	Kon-Tiki
霓裳魅影	Phantom Thread
明月幾時有	Our Time Will Come
驚聲尖笑4	Scary Movie 4
黑暗文藝復興	Renaissance
蒙古王	Mongol
全面封鎖	Unlocked
比佛利拜金狗	Beverly Hills Chihuahua
拳力突襲	Wild Card
玩命鎗火	Free Fire
玻璃城堡	The Glass Castle 
無路可退	Only the Brave 
塔克,嘿咻嘿咻嘿咻!	I Hope They Serve Beer in Hell
大娛樂家	The Greatest Showman 
汽車總動員3	CARS 3
超人集中營	Zoom
當辣妹來敲門	Knock Knock 
派拉諾曼:靈動小子	ParaNorman
尋找艾瑞克	Looking for Eric 
完美社區謀殺案	Suburbicon
侏羅紀世界2	Jurassic World: Fallen Kingdom
夢遊大都會	Cosmopolis
獵男有轉機	The Layover 
在地圖結束的地方	Timbuktu
陰兒房3	Insidious Chapter 3
狩獵者:凜冬之戰	The Huntsman Winter’s War
資本遊戲	Capital
太陽馬戲團	Cirque du Soleil: Worlds Away 3D
野獸婆婆	Monster-in-Law
燃燒鬥魂	The Fighter
青春倒退嚕	While We're Young
拒絕再戰	Stop-Loss
哈利波特6	Harry Potter and the Order of the Phoenix
後街天使	Or 
3D怒火狂飆	Drive Angry 3D
決戰異世界5	Underworld: Blood Wars
Lady's尖頭們	Free the Nipple 
別來敲門	Don't Come Knocking 
拳霸	Ong-Bak: The Thai Warrior 
阿宅的二三事	Jeff, Who Lives at Home
叢林法則	Joe
雙子陰謀	Leaves of Grass
惡靈空間	Boogeyman
黛安娜	Diana
舊情人	The Ex
茉莉人生	Persepolis
神鬼剋星	The Brothers Grimm
3D驚天洞地	Sanctum
羅賓漢	Robin Hood
活蟲生吃	How to Eat Fried Worms
愛上草食男	Greenberg
夾心蛋糕	Layer Cake 
魔境夢遊2	Alice Through the Looking Glass 
情場大玩咖	Playing for Keeps
好景不常	All Good Things
賴家王老五	Failure to Launch
春麗傳奇	Street Fighter: The Legend of Chun-Li
檔案	The Quiet Ones 
婚禮大聯矇	The Big Wedding
毛的最後舞者	Mao's Last Dancer
十年	10 Years 
索爾之子	Son of Saul
吸血鬼獵人	Abraham Lincoln: Vampire Hunter
安諾瑪麗莎	Anomalisa
意外	Three Billboards Outside Ebbing, Missouri
不可能的任務5	Mission: Impossible 5
12怒漢:大審叛	12
捍衛真相	Nothing But the Truth
入侵者	Intruders
花邊藥頭	Twelve
搖滾學校	Rock School 
百萬種硬的方式	A Million Ways to Die in the West
不思議女人	A Fantastic Woman
瘋狂之心	Crazy Heart
不再讓你孤單	A Beautiful Life
結婚糾察隊	License to Wed
奇幻世界	Tideland
比利林恩	Billy Lynn’s Long Halftime walk
說來有點可笑	It's Kind of a Funny Story
麻吉伴郎	I Love You, Man
暴力	A History of Violence
無賴速成班	School for Scoundrels
拳霸2	The Protector
第十四道門	Coraline
屍控	[Rec] 2
烈焰青春	Standing Tall
計程車司機之死	Taxi to the Dark Side
暮光之城3	The Twilight Saga: Eclipse
戀夏小情歌	God Help the Girl
戰慄時空	The Jacket
同遊義大利	The Trip to Italy 
曼羅奇遇記	Book of Life 
救命解藥	A Cure For Wellness
綠光戰警	Green Lantern
港囧	Lost in Hong Kong
晚安!祝你好運	Good Night. And, Good Luck
午夜巴黎	Midnight in Paris
灰熊人	Grizzly Man
拳頭生涯原是夢	From Mexico with Love 
重擊戒備	Welcome to the Punch 
康乃狄克鬼屋事件2	The Haunting in Connecticut 2: Ghosts of Georgia
已經很想妳	Miss You Already
女朋友男朋友	GF。BF
天生男優	Bucky Larson: Born to be a Star
B咖戰警	The Other Guys
凱文怎麼了	We Need to Talk About Kevin
送子鳥	Storks
迷網女孩	Trust
星際爭霸戰2	Star Trek Sequel
鼠國流浪記	Flushed Away
達拉斯362	Dallas 362 
命中注定多個你	Life As We Know It
特務殺很大	3 Days to Kill 
瑜珈熊	Yogi Bear
輝煌年代	Elizabeth: The Golden Age
大犯罪家	The Clan
無厘取鬧3D	Jackass 3D
殺戮禁區	Shooting Dogs 
扣押幸福	Freeheld
活命條件	Point Blank
別怕黑	Don't Be Afraid of the Dark
夜夜成癮的男人	The Good Night
的中場戰事	Billy Lynn’s Long Halftime walk
緣星夢	Undiscovered
攻殼機動隊	Ghost in the Shell
惡女訂製服	The Dressmaker
醉後大學生	21 and Over
誰敢來早餐	Dead And Breakfast 
東方快車謀殺案	Murder on the Orient Express
愛上野豬妹	The Hottie & the Nottie
末路凶宅	House At The End of the Street
愛,讓悲傷終結	Rabbit Hole
聖境預言書	The Celestine Prophecy
鴻孕當頭	Juno
剝頭煞星	Maniac 
假期	Last Holiday
我們的故事未完待續	Me and Earl and the Dying Girl
美國隊長3	Captain America 3: Civil War 
心的歸屬	Then She Found Me 
愛情停看聽	Learning to Drive
不可能的任務4	Mission: Impossible Ghost Protocol
誰敢來晚餐	Guess Who
嚎囂	Howl
牛仔褲的夏天	The Sisterhood of the Traveling Pants 
旅行的意義	My Life in Ruins
神秘肌膚	Mysterious Skin
快樂腳	Happy Feet
今晚誰當家	Carnage
遜咖冒險王3	Diary of a Wimpy Kid: Dog Days
冰血奇緣	Dead Snow 2: Red vs. Dead 
危機	Our Brand Is Crisis 
孩子	The Child
神鬼傳奇	The Mummy 
上帝在我家	Henry Poole is Here
巴黎拜金女	Priceless
X檔案2	The X Files 2
情聖兄弟	The Brothers Solomon
天才無限家	The Man Who Knew Infinity 
玩命賭徒	The Gambler 
水中的女人	Lady in the Water
隱藏攝影機	Hidden
高校寫真	Palo Alto
殲滅十三區	Assault on Precinct 13 
愛情摩天輪	Wonder Wheel 
黑街神話	Streets of Legend
愛上火星男孩	The Space Between Us
侏羅紀世界	Jurassic World 
冤親債主	The Bye Bye Man 
慾謀	Stoker
限制級褓母	The Pacifier
音樂之光	I Saw the Light
榮耀泳隊	Pride
笨賊樂盜家	Masterminds
媽媽咪呀!	Mamma Mia!
臨門湊一腳	Due Date
胡士托風波	Taking Woodstock
遺失的映像	The Missing Picture
雷神索爾2	Thor: The Dark World
獵魔教士	Priest
史瑞克四	Shrek Forever After
殺手輓歌	The Memory of a Killer 
哈啦猛男秀2	Deuce Bigalow: European Gigolo
藍色情人節	Blue Valentine
五星主廚快餐車	Chef 
逃出熔爐	Out of the Furnace
命懸六百哩	600 Millas 
義國戀	Everybody Wants to Be Italian
求愛馬拉松	Run, Fat Boy, Run
妖瘦男	Slender Man 
彩虹小馬大電影	My Little Pony: The Movie
紳士與流浪漢	Same Kind of Different as Me
愛在巴黎破曉時	Le Week-End
鼠來寶3	Alvin and the Chipmunks - Chipwrecked
世界盡頭	Off the Map 
出竅情人	Just Like Heaven
愛情達陣	Leatherheads
忍者刺客	Ninja Assassin
活屍禁區	George A. Romero's Land of the Dead
仙鏡奇緣	MirrorMask 
蜂蜜罐上的聖瑪利	The Secret Life of Bees
3D血護士	Nurse 3D
魔法玩具城	Mr. Magorium's Wonder Emporium
3D地心冒險	Journey 3-D
希望在世界另一端	The Other Side of Hope
史努比	Peanuts
聖安娜奇蹟	Miracle at St. Anna
鬼霧	The Fog
尋找阿娜答	The Perfect Man 
美味關係	Julie & Julia
大災難家	The Disaster Artist 
衝破顛峰	Lords of Dogtown
科學怪犬	Frankenweenie
金牌製作人	The Producers
俠盜聯盟	The Adventurers
重返海豚灣	Dolphin Tale
劫婚典禮	Ceremony
萬鱷巨獸	Primeval
魔鬼約書亞	Joshua
明日定律	The Zero Theorem
鄰家特務	The Spy Next Door
私法正義	Seeking Justice
白日夢冒險王	The Secret Life of Walter Mitty
百萬小富翁	Millions
明日的記憶	Memories of Tomorrow
猜心	The Painted Veil
奧斯卡的一天	Fruitvale Station
換命法則	Self/less 
疾風禁區	Goal! The Dream Begins 
流離者之歌	Dheepan
大眼睛	Big Eyes 
波斯王子	Prince of Persia: The Sands of Time
馬利與我	Marley & Me
赤誠者	The Divergent Series: Allegiant 
逐浪而生	Run the Tide 
贏向一生的挑戰	The Game of Their Lives
迷霧驚魂	Stephen King's The Mist
請問總統先生	Frost/Nixon 
怪獸大戰外星人	Monsters vs. Aliens 
往下跳	A Long Way Down
針情法網	Puncture
神隱任務2	Jack Reacher 2
往事隨風	Diminished Capacity
天堂五分鐘	Five Minutes of Heaven
紙上城市	Paper Towns
最後那五年	The Last Five Years 
笑逐顏開	Smile 
驚聲尖叫4	Scream 4
魔術師	The Illusionist 
魔由心生	The Killer Inside Me
園長夫人:動物園的奇蹟	The Zookeeper's Wife
一無所有	Everything Must Go
五月風暴	Something in the air
狐狸捕手	Foxcatcher
玩命關頭5	Fast Five
雷霆萬鈞	A Sound of Thunder
梅西的世界	What Maisie Knew 
女人至上	The Women 
暮光之城4:破曉Ⅱ	The Twilight Saga: Breaking Dawn - Part 2
孤雛淚	Oliver Twist 
超危險特工2	Red 2
列車上的女孩	The Girl on the Train 
我愛你	I Love You, Beth Cooper
絕命追緝令	Alex Cross
愛在愛情空窗期	愛在愛情空窗期
樂觀以對	Happy-Go-Lucky
靈魂樂手	Soul Men
往生路	The Road 
傑克巨人戰記	Jack the Giant Killer
誘禍	Don't Tell
香奈兒的秘密	Coco Chanel & Igor Stravinsky 
偷天劫車手	Collide
心塵情緣	Ask the Dust
潛龍突擊隊	Renegades
金陵十三釵	The Flowers of War
飯飯之交	No Strings Attached
盜數計時	Stolen
謊顏	Time
奪魂鋸5	Saw V
狙擊手	Good Kill 
誰來愛我	Holding Trevor 
親愛的別哭	Declaration of War
波西傑克森2	Percy Jackson: Sea of Monsters
我們算正式交往嗎？	That Awkward Moment 
寂寞拍賣師	The Best Offer
速食國度	Fast Food Nation
樂自心中來	Music Within
致命巧克力	Chocolate
神鬼奇航2	Pirates of the Caribbean: Dead Man's Chest
休旅任務	RV
謝謝分享,我的愛	Thanks for Sharing 
賠我走這一程	Off the Black
吮指	Thumbsucker
星際大戰8	Star Wars: Episode VIII: Space Bear  
葉問3	Ip Man 3
美女與野獸	Beauty and the Beast 
關塔那摩X光營	Camp X-Ray 
巨塔殺機	Eastern Promises
自由大道	Milk
震盪	Concussion
林來瘋	Linsanity
陰兒房2	Insidious Chapter 2
快樂舞年級	Mad Hot Ballroom 
地海戰記	Tales from Earthsea 
馬達加斯加3	Madagascar 3: Europe's Most Wanted 
天使與魔鬼	Angels & Demons 
2016美國甜心	American Honey 
魔女嘉莉	Carrie
靈異航班	Passengers
獵頭遊戲	Headhunters
逐愛天堂	Angel
特攻聯盟2	Kick-Ass 2
刺殺傑西	The Assassination of Jesse James by the Coward Robert Ford
湖畔春光	Stranger by the Lake
溫特的故事2	Dolphin Tale 2
小腳怪	Smallfoot
心碎時光	Fugitive Pieces
藍色小精靈	The Smurfs
大學預備生	College
地獄怪客2	Hellboy 2
鬼哭人嚎	Town Creek 
夏日時光	Summer Hours 
漫漫回家路	Lion
夢想啟動	Spare Parts 
婚禮之後	After the Wedding
極地熊寶貝	Arctic Tale
非死不可	Friend Request 
蜂狂	Stung
插畫情緣	Dedication
─思想的行動	Vita Activa: The Spirit of Hannah Arendt
海賊天團	The Pirates! Band of Misfits
時空旅人之妻	The Time Traveler's Wife
恐懼虛空	The Void
驚爆焦點	Spotlight
時空效應	I'll Follow You Down 
東京奏鳴曲	Tokyo Sonata
厄夜叢林3	Blair Witch 
賞鳥的一年	The Big Year
嫁禍手段	Crossing Over
瘋狂農莊	Barnyard
特務風雲	The Good Shepherd
全家玩到趴	Vacation
大衛特大號	Meet Dave
人再囧途之泰囧	Lost in Thailand
臨時派報員	The Paperboy
小姐好窮	From Prada To Nada
鬼入鏡4	Paranormal Activity 4
辣妹愛宅男	She's Out of My League
超級盃奶爸	The Game Plan
勇士之家	Home of the Brave 
博物館驚魂夜2	Night at the Museum: Battle of the Smithsonian
精銳部隊	Elite Squad 
靈界線	Requiem
總統遊戲	Big Game
哈瑪斯之子	The Green Prince
幸福不設限	About Ray
金牌黑幫	Legend
落日車神	Drive
羅雷司	Dr. Seuss' The Lorax
靈異孤兒院	The Orphanage
舞動心方向	Marilyn Hotchkiss' Ballroom Dancing and Charm School
漢娜鄂蘭	Vita Activa: The Spirit of Hannah Arendt
愛情全壘打	Fever Pitch
玩咖尬宅爸	The Change-Up
貝伍夫:把愛找回來	August Rush
婚禮的祝福	Margot at the Wedding
麥克邁:超能壞蛋	Megamind
怪獸大學	Monsters University
鬼撕眠	Before I Wake 
眼鏡蛇男神	King Cobra 
白日夢孩子王	Wish I Was Here 
暴風雨	The Tempest
萬惡城市2	Sin City: A Dame to Kill For
甜心殺手	Miss Meadows
博物館驚魂夜3	Night at the Museum 3
名模大間諜2	Zoolander 2
異星大作戰	Attack the Block
美人魚之戀	Aquamarine
傲慢與偏見與殭屍	Pride and Prejudice and Zombies 
決戰新世界	The New World
凱蒂佩芮:做我自己	Katy Perry: Part of Me
末日危城	In the Name of the King: A Dungeon Siege Tale 
酷狗寶貝	Wallace & Gromit - The Curse of the Were-Rabbit
聖母峰	Everest 
即刻毀滅	Burn After Reading
露西	Lucy
中央情報局	Central Intelligence 
無聲火	Bangkok Dangerous
黑金企業	There Will Be Blood
斷背山	Brokeback Mountain 
魔鬼孩子王2	Kindergarten Cop 2
機器人歷險記	Robots
珍愛人生	Precious: Based on the Novel "Push" by Sapphire
白宮末日	White House Down 
失落之城	The Lost City of Z
美國狙擊手	American Sniper
證明我愛你	Proof
2016:歐巴馬的美國	2016: Obama's America 
馬達加斯加	Madagascar
愛情超能量	Death of a Superhero 
拉貝日記	John Rabe 
鬼開門	The Disappointments Room 
寂寞星圖	Maps to the Stars 
殺戮行動	Killing Them Softly 
西遊記之孫悟空三打白骨精	The Monkey King 2
紳士密令	The Man From U.N.C.L.E.
花痴	Black Snake Moan
蘇珊夫人尋婚計	Love & Friendship
屍房宴	We are What we are
醉快活	Factotum
女權之聲:無懼年代	Suffragette
巴爾札克與小裁縫	Balzac and the Little Chinese Seamstress
頻率	The Night Listener
長江七號	CJ7
扭轉時光機	Hot Tub Time Machine
幸運符	The Lucky One
殺手保鑣	The Hitman’s Bodyguard
玩酷壞痞子	The Preppie Connection
鐵娘子	The Iron Lady
盲女驚心	All I See Is You
安娜貝爾	Annabelle
四眼天雞	Chicken Little
愛在午夜希臘時	Before Midnight
鋼鐵人3	Iron Man 3
西伯利亞漂流	Happy People: A Year in the Taiga
慾望城市2	Sex and the City 2
哈拉婚禮2	The Best Man Holiday 
恐龍當家	The Good Dinosaur
等妳到永遠	Waiting for Forever
怪物來敲門	A Monster Calls 
帝國戰神	Baahubali: The Beginning
刺客共犯	The Conspirator
大學生做了沒	The To Do List 
母親,愛情的限度	Ma Mere
破碎的擁抱	Broken Embraces
重振雄風	Stand Up Guys
無人生還	No One Lives 
硬漢教育	The Man
鴿戰	Valiant
豆豆假期	Mr. Bean's Holiday
我行我素	The Chumscrubber 
我老爸卡好	That's My Boy
復仇者聯盟2	Avengers: Age of Ultron 
壁壘分局	Rampart
凱薩萬歲	Hail, Caesar!
單身女郎派對	Bachelorette
傳奇42號	42
龍虎少年隊2	21 Jump Street 2
布達佩斯大飯店	The Grand Budapest Hotel 
白色緞帶	The White Ribbon 
我的藍莓夜	My Blueberry Nights
火星救母記	Mars Needs Moms
怒火特攻隊	Fury
安娜卡列妮娜	Anna Karenina
即刻救援3	Taken 3 
猛龍怪客	Death Wish
噪反城市	Sound of Noise
美國派:高潮再起	American Reunion
滿城盡帶黃金甲	Curse of the Golden Flower
郵報:密戰	The Post 
表情符號電影	The Emoji Movie 
百老匯風流記	She’s funny that way
心碎排行榜	Broken Flowers
鯊魚愛老鷹	Eagle vs. Shark
藍色小精靈3	Smurfs: The Lost Village 
重振聲威	Resurrecting the Champ
牙仙大帝	Tooth Fairy
變形金剛4	Transformers 4
神偷奶爸	Despicable Me
玫瑰人生	The Passionate Life of Edith Piaf
反擊	Blackway
萬聖夜怪譚	Tales of Halloween 
記憶乍響	Louder Than Bombs
頤和園	Summer Palace 
3DD食人魚	Piranha 3DD 
玩命特區	Brick Mansions 
天使威士忌	The Angels' Share 
蜘蛛人	The Amazing Spider-Man 2
本片尚未分級	This Film is Not Yet Rated
黑暗時刻	The Darkest Hour
好孕臨門	Knocked Up
搏命關頭	Hours
閃亮小天后	Bratz
獵殺活死人	Undead
女巫獵人	Hansel and Gretel: Witch Hunters
超時空攔截	Predestination
絕處逢山	The Mountain Between Us
蜂王季	Bee Season
時尚帝國合約的開始	The Model
胖尼殺很大	Bernie
亡命快劫	The Taking of Pelham 1 2 3
華爾街之狼	The Wolf of Wall Street
蘇乞兒	True Legend 
解構新鮮人	Poison Friends 
烈火焚身	Incendies
夜行動物	Nocturnal Animals 
投名狀	The warloads
再見鍾情	A Lot Like Love
最炎熱的州	The Hottest State
更好的世界	In a Better World
裸體舞台	Mrs. Henderson Presents
錢藏凶機	The Drop 
我的左派哥哥	My Brother Is An Only Child
皮相獵人	Fur
風起	The Wind Rises
第44個孩子	child 44
打獵季節	Open Season
蠢蛋搞怪秀2	Jackass 2
居家風暴	The Details
世紀戰魂	Centurion 
噬血童話	Let Me In
奪魂鋸8	Saw: Legacy 
尋秘街拍客	Finding Vivian Maier 
遲來的	Philomena
尖峰時刻3	Rush Hour 3
惡棍特工	Inglourious Basterds
屁王蜘蛛	Big Ass Spider
搖滾女王	Ricki and the Flash
靈魂冷凍庫	Cold Souls
伴唱人生	Twenty Feet from Stardom
星際大戰:威脅潛伏3D	Star Wars: Episode I The Phantom Menace 3D
顫慄柏林	Berlin Syndrome
三隻猴子	Three Monkeys 
超世紀封神榜	Clash of the Titans
星際大戰外傳:俠盜一號	Rogue One: A Star Wars Story 
育陰房	Shut In 
怒火邊界2	Sicario 2: Soldado
破處女王	Easy A
老娘叫譚雅	I, Tonya
太極俠	Man of Tai Chi 
老闆不是人	Horrible Bosses
生命中最抓狂的小事	Wild Tales
魔角	Horns
分居風暴	A Separation
百萬殺人遊戲	13 Tzameti
求愛女王	All About Steve
八十八分鐘	88 Minutes
藍色茉莉	Blue Jasmine
同盟鶼鰈	Allied
性愛搖滾樂	9 Songs
毀滅戰士	Doom
萬惡夜總會	We Own the Night
浪人47	47 Ronin
肉腳擂台	Here Comes the Boom
暮光之城4:破曉I	The Twilight Saga: Breaking Dawn - Part 1
失樂園	Paradise Lost
美國小三	Mistress America 
我和我的冠軍女兒	Dangal
黑社會2	Election 2
歡樂合唱團3D	Glee: The 3D Concert Movie
月光光心慌慌2	H2
第六感追緝令2	Basic Instinct 2: Risk Addiction
烏克蘭悲歌	Bitter Harvest
驚奇四超人	Fantastic Four
鎖命橫財	Good People
雙鼠記	The Tale of Despereaux
當麥克先生遇見夢露小姐…	Mister lonely
攻敵必救	Miss Sloane
賭國大丈夫	Mississippi Grind 
愛在彈指間	Populaire
獨步舞林	Stomp the Yard
魔物戀人	Spring
諜海無間	The November Man 
她其實沒那麼壞	The Last Word 
歐吉桑鄰好	St. Vincent 
封神傳奇	League of Gods
生存者	The Bad Batch 
赴湯蹈火	Hell Or High Water
月光下的藍色男孩	Moonlight
地球迴聲	Earth to Echo 
倒數行動	Survivor
虛擬天后	The Congress
我想念我自己	Still Alice
帝國警戒	Empire State
愛睡在一起	Sleeping With Other People
恐怖拜訪	The Invasion 
2012	2012
謊言對決	House of Lies
魔髮奇緣	Tangled
雪季過客	Snow Cake
惡鄰纏身2	Neighbors 2
冰旅記事	Encounters at the End of the World 
活著的男孩	The Only Living Boy in New York
星際大奇航	The Hitchhiker's Guide to the Galaxy
綁架海尼根	Kidnapping Mr. Heineken
冰封之地	The Frozen Ground
香水	Perfume: The Story of a Murderer 
怪胎鎮	Weirdsville
環太平洋	Pacific Rim
腦筋急轉彎	Inside Out 
半夜鬼上床	A Nightmare on Elm Street
狄倫犬:惡夜偵探	Dylan Dog: Dead of Night
PS.我愛	P.S. I Love You
降魔戰警	R.I.P.D.
大事件	Breaking News 
女神賽爾瑪	Thelma
銀翼殺手2	Blade Runner 2
超人特攻隊2	Incredibles 2
多虧有你	Because of Winn-Dixie
南國傳奇	Southland Tales
沙漠神兵	Special Forces
全面攻佔2	London Has Fallen
粉紅豹2	The Pink Panther 2
雪地迷蹤	The Captive 
天者天下	Kingdom of Heaven
相信你的男人	Trust the Man
福爾摩斯	Sherlock Holmes 
自殺突擊隊	Suicide Squad
不請自來	The Uninvited 
派特的幸福劇本	Silver Linings Playbook
昨夜風流	About Last Night 
姊妹	The Help
飢餓遊戲3	The Hunger Games: Mockingjay - Part 1
蘇格蘭之王	The Last King of Scotland
勝負反手拍	Battle of the Sexes 
陌生之地	Strangrland
吸血鬼學院	Vampire Academy
古墓奇兵	Tomb Raider
當幸福來敲門	The Pursuit of Happyness
維納斯	Venus
惡劣的善意	The Vicious Kind 
快克殺手2	Crank: High Voltage
麥可—我的直男前男友	I Am Michael 
國王贖金	King's Ransom
一個人的旅行	Eat, Pray, Love
我就要你好好的	Me Before You
戀愛沒有假期	The Holiday
直播風暴	The Circle
艾莉塔:戰鬥天使	Alita: Battle Angel
遺落戰境	Oblivion
怪物遊戲	Goosebumps
布偶歷險記2	Muppets Most Wanted
15:17巴黎列車	The 15:17 to Paris
真情旅程	The Lucky Ones
聯合縮小兵	The Ant Bully
攻無不克	When the Game Stands Tall 
凱文怎麼了？	We Need to Talk About Kevin
骸骨之城	The Mortal Instruments: City of Bones
少年彌賽亞	The Young Messiah 
天堂此時	Paradise Now 
瘋婆娘日記	Diary of a Mad Black Woman
亡命千萬里	The Way Back
輕狂時代	Ten Thousand Saints 
神鬼大盜	Mortdecai
風流才子	The Libertine
血色入侵	Let the Right One In
樓上鄰居外星人	Aliens in the Attic
霍頓的鐵道人生	O'Horten
防火牆	Firewall
月光魔法	Magic in the Moonlight
屍速列車	Train to Busan
時間殺人	Timecrimes
歌喉讚	Pitch Perfect
神鬼認證3	The Bourne Ultimatum
賓漢	Ben-Hur 
所羅門傳奇	Solomon Kane
日式牛仔一品鍋	Sukiyaki Western Django 
牛津殺人魔	The Oxford Murders 
愛與親愛的	The Other Woman 
驚奇四超人2	Fantastic Four: Rise of The Silver Surfer
女狼嗨到趴	Rough Night
名牌冤家	Did You Hear About the Morgans?
暴力年代	A Most Violent Year
沉默	Silence
閨蜜假期	Girls Trip 
春心蕩漾	Prime
夏綠蒂的網	Charlotte's Web
柯波帝:冷血污名	Infamous
真愛無韁	Flicka
氣象戰	Geostorm
空戰英豪	Flyboys
赤壁	Red Cliff
快樂結局	Happy Endings
珍奧斯汀讀書會	The Jane Austen Book Club
天堂邊緣	The Edge of Heaven 
穿著Prada的惡魔	The Devil Wears Prada
天龍特攻隊	The A-Team
雙面瑪琳達	Melinda and Melinda 
死神魔菇	Shrooms
巡邏驚很大	Neighborhood Watch
倫敦大道	London Boulevard 
絕地再生	The Island
奪魂鋸3D	Saw VII 3D
感謝您為國效力	Thank You for Your Service 
神鬼奇航3	Pirates of the Caribbean: At Worlds End
糯米歐與茱麗葉	Gnomeo & Juliet
鬼入鏡:詛咒	Paranormal Activity: The Marked Ones
渦輪方程式	Turbo
跳越時空的情書	The Lake House 
私刑教育	The Equalizer 
美麗誘惑	A Good Woman
派對X檔案	Project X
微光城市	City of Ember 
金錢世界	All The Money In The World
愛重逢以後	Valley of Love
007空降危機	Skyfall
加菲貓2	Garfield's A Tale of Two Kitties
追憶燦爛年華	My Golden Days
回魂	The Return
撒哈拉	Sahara
Kuso小紅帽2	Hoodwinked Too! Hood vs. Evil
亞瑟:王者之劍	King Arthur: Legend of the Sword 
異人族	Inhumans
柏靈頓2:熊熊出任務	Paddington 2
移動城市:致命引擎	Mortal Engines
最後尖叫女王	Final Girl
雙面特工	Breach
高年級實習生	The Intern
我的父親羅慕勒斯	Romulus, My Father
約會喔麥尬	Date Night
高校女特務	D.E.B.S. 
西西里的漫長等待	The Wait
祖父母囧很大	Parental Guidance
孤單男人	Solitary Man
911絕命電梯	9/11
貓狗大戰2	Cats & Dogs: The Revenge of Kitty Galore
卡內陰	Incarnate
悲慘世界	Les Miserables
第九禁區	District 9
狼心仁術	The Good Doctor 
卡特教頭	Coach Carter
殺手沒有假期	In Bruges
誰來叩應	Talk to Me
神偷獵人斷指客	The Good, the Bad and the Weird 
腦波遊戲	MindGamers
熾天之翼	Red Tails
非洲大貓	African Cats
無人知曉夏日清晨	Nobody Knows 
六人行不行	And If We All Lived Together
真情不打烊	10 Items or Less
百萬殺人實驗	百萬殺人實驗
愛墮落	Adore
奮戰不懈	Forever Strong
速食遊戲	The Founder
深海挑戰3D	James Cameron's Deepsea Challenge 3D 
納尼亞傳奇	The Chronicles of Narnia: The Lion, The Witch and The Wardrobe 
左右逢緣	In the Land of Women
金盞花大酒店	The Best Exotic Marigold Hotel
登堂入室	In the House
明星夢工廠	Factory Girl
直搗蜂窩的女孩	The Girl Who Kicked the Hornet's Nest
這該死的愛	Charlie Countryman
失序人生	The Life Before Her Eyes
神偷奶爸3	Despicable Me 3
頑劣份子	Hesher 
超人高校	Sky High
上帝之子	Son of God 
捍衛任務2	John Wick 2 
越夜越狂	The Overnight
危險療程	A Dangerous Method
金龜車賀比	Herbie: Fully Loaded
即刻救援2	Taken 2
復仇者聯盟	The Avengers
歌神	El Cantante
機戰未來	Stealth
神鬼奇航4	Pirates of the Caribbean: On Stranger Tides
人神之間	Of Gods and Men
氣男孩	Steamboy 
海明威好賊	Dom Hemingway
末日碉堡	The Divide
家有兩個爸	Daddy's Home 
疏離世界	Disconnect
300壯士2	300: Rise of an Empire 
美麗魔物	Beautiful Creatures
諜對諜	Syriana
原罪犯美國版	Oldboy 
厲陰宅2	The Conjuring 2
所向披靡	Invincible
別讓我走	Never Let Me Go
人形蜈蚣	The Human Centipede
吟遊戀人	Once
尋找左宗棠	The Search for General Tso 
地獄	Inferno
賈伯斯	Jobs
梵谷:星夜之謎	Loving Vincent 
野蠻遊戲	Jumanji: Welcome to the Jungle
鼠來寶4	Alvin and the Chipmunks: The Road Chip 
刑前教育	Get Hard
樂動	Bravetown
玩命左輪	Revolver
夏日大作戰	Summer Wars
牛仔褲的夏天2	The Sisterhood of the Traveling Pants 2
風暴佳人	Agora
母親劫	Mother's Day
綠街大火拼	Green Street Hooligans
3人擠不擠	Three
愛情無時差	It's Already Tomorrow in Hong Kong 
舊愛找麻煩	Ghosts of Girlfriends Past
激樂人心	Get on Up 
狼圖騰	Wolf Totem
鳴梁:怒海交鋒	Roaring Currents
黑暗騎士:黎明昇起	The Dark Knight Rises
勾引陌生人	Perfect Stranger
追風箏的孩子	The Kite Runner
我家也有大明星	Entourage
瞞天過海:八面玲瓏	Ocean's 8
鼠來寶2	Alvin and the Chipmunks: The Squeakuel
天衣無縫	Flawless
大亨小傳	The Great Gatsby 
玩命快遞3	Transporter 3
送行者	Departures
計程人生	Taxi
阿呆與阿瓜2	Dumb and Dumber To
逃出絕命鎮	Get Out 
美麗壞姐妹	Pretty Persuasion 
愛,不散	Love Is Strange 
全民情獸	Zookeeper
寫意人生	Writers
嫩男謝利	Cheri
下流高校	Dirty Deeds
獅子王3D	The Lion King 3D
池畔謎情	A Bigger Splash 
他們的美好時光	Their Finest
潛意識夢遊	The Science of Sleep
莎士比亞的秘密	Anonymous
戰神世紀	Immortals
歐吉桑卡好	Old Dogs
刺殺據點	Vantage Point
歌喉讚3	Pitch Perfect 3
龍紋身的女孩	The Girl with the Dragon Tattoo 
我家也有消防狗	Firehouse Dog
5X2愛情賞味期	5x2 
終極	Precious Cargo
愛在紐約破曉時	Heights 
紐約二日情	2 Days in New York 
雪莉寶貝	Sherrybaby
怪獸高中	Freaks of Nature
小黃狗的窩	The Cave Of The Yellow Dog 
異星智慧	Life
超危險人物	Starred Up
最後一次自由	Desierto
功夫貓熊	Kung Fu Panda
尼斯湖水怪	The Water Horse: Legend of the Deep
金爆內幕	Gold
哭聲	The Wailing 
奇異博士	Doctor Strange
奧瑪的抉擇	Omar
曼哈頓奇緣	Enchanted
終極救援	Extraction
我的意外老公	The Accidental Husband
移動世界	Jumper
超完美告別	Death at a Funeral
捍衛任務	John Wick 
玩命快遞4	The Transporter Legacy
笑翻清真寺	Looking for Comedy in the Muslim World
小孩好黑	Little Man
依達的抉擇	Ida
全面逃殺	Gunman
無人出席的告別式	Still Life 
赤眼玄機	Red Eye
愛在不言中	Enough Said 
ID4星際終結者2	Independence Day 2: Resurgence
我的明星老爸	Somewhere
嫁期	The Wedding Date
史密斯任務	Mr. and Mrs. Smith
熾色炫風	Redline
樂高蝙蝠俠電影	The Lego Batman Movie
生命中的美好缺憾	The Fault in Our Stars 
浴血任務3	The Expendables 3
居住正義	99 Homes 
菜鳥搶銀行	30 Minutes or Less
忍者龜2:出神入化2	Now You See Me: The Second Act
鐵腕豪情	Appaloosa
驚夜誰保姆	The Sitter
金剛	King Kong
滑輪風暴	Skateland
求生127小時	127 Hours
查泰萊夫人	Lady Chatterley 
巴黎小情人	The Beautiful Person
王者之劍:太空戰士15電影版	Kingsglaive: Final Fantasy XV
愛在山谷下	Down in the Valley
黑帽	Blackhat
颱風	Typhoon
陌路狂殺2	The Strangers: Prey at Night
叛諜風暴	Rosewater
動物方城市	Zootopia
大獄言家	A Prophet 
不公平的戰爭	Fair Game
愛情限時簽	The Proposal 
百老匯熟男日記	The Humbling
奪命潘朵拉	Wish Upon
神出鬼沒	Exists
39號特案	Case 39
九度空間	The Nines
雙面危敵	Enemy
喋血街頭	Postal
丹麥女孩	The Danish Girl
格雷的五十道陰影2	Fifty Shades Darker
仙履奇緣	Cinderella
麻辣女王2	Miss Congeniality 2: Armed and Fabulous
蜜妮初體驗	Mini's First Time
別跟山過不去	A Walk in the Woods
驅魔	The Exorcism of Emily Rose
問鼎奧斯卡	For Your Consideration
極凍之城	Atomic Blonde
敢愛敢當	Dare
美國隊長2	Captain America: The Winter Soldier
榮耀大道	Main Street
魔法師的學徒	The Sorcerer's Apprentice
星際特工瓦雷諾:千星之城	Valerian and the City of a Thousand Planets 
暮光之城2	The Twilight Saga: New Moon
會計師	The Accountant 
我們買下了動物園	We Bought a Zoo
變裝皇后萬萬歲	Viva 
鬼次元	The Apparition
腥紅山莊	Crimson Peak 
藍色是最溫暖的顏色	Blue is the Warmest Color 
猜火車2	T2: Trainspotting
9	9
少年Pi的奇幻漂流	Life of Pi
凝視瑪莉娜	Marina Abramovic: The Artist Is Present
山	The Hills Have Eyes
愛的餘燼	The Broken Circle Breakdown 
簡愛	Jane Eyre
愛無悔	No Regret 
魔鬼總裁	Misconduct
尖叫旅社3	Hotel Transylvania 3
東京狂想曲	TOKYO ! 
女生殺人宿舍	Sorority Row 
立體小奇兵	The Adventures of Shark Boy and Lava Girl in 3-D
人之初	I Origins 
插旗攻城市	Where to Invade Next
巴黎妓院回憶錄	House of Pleasures
老闆我最大	The Boss of It All
逆轉王牌	Runner Runner 
我恨情人節	I Hate Valentine's Day
紅氣球	The Flight of the Red Balloon
末路殺神	Only God Forgives
惡夜特警隊	Brooklyn's Finest
黑海	Black Sea 
七生有幸	Seven Pounds
愛情避風港	Safe Haven
隨心所欲	Wanderlust
海邊	By the Sea
奇幻精靈事件簿	The Spiderwick Chronicles
異形戰場2	Alien vs. Predator 2
愛慾癡狂	Asylum
黑綿羊	Black Sheep 
醜聞筆記	Notes on a Scandal
鼠膽妙算	G-Force
路易的第9條命	The 9th Life of Louis Drax
琴謎變奏曲	The Page Turner
怪怪屋	Monster House
巴菲特報告	I.O.U.S.A.
偷書賊	The Book Thief
聖誕佳節	Nothing Like the Holidays
恐怖解剖室	Pathology
有人在家嗎?	Is Anybody There?
強森好屌	Bad Johnson 
心靈小屋	The Shack
垂死的肉身	Elegy
烏龜也會飛	Turtles Can Fly 
非普通教慾	Dogtooth
死侍2	Deadpool 2
希區考克	Hitchcock
光榮時刻	Outside The Law
亞當等大人2	Grown Ups 2
A片女神	Lovelace
為妳說的謊	The Light Between Oceans
壁花男孩	The Perks of Being a Wallflower
101夜情	Sex and Death 101 
死期倒數24小時	My Soul to Take
我的生存之道	How I Live Now 
蜂電影	Bee Movie
那時候,我只剩下勇敢	Wild
一代宗師	The Grandmasters
單身動物園	The Lobster 
玩命車手	Vehicle 19
哈利波特7.1	Harry Potter and the Deathly Hallows - Part 1
國定殺戮日2	The Purge: Anarchy 
三個臭皮匠	The Three Stooges
最後的球季	The Final Season
湖濱疑雲	Jindabyne
愛•慕	Amour
林肯傳	Lincoln
乒乓特派員	Balls of Fury
分手的那一天	(500) Days of Summer
絕命終結站5	Final Destination 5
神鬼制裁2	Punisher: War Zone
天方夜	Bedtime Stories
變形金剛5	Transformers: The Last Knight
堅果任務	The Nut Job 
蒙面俠蘇洛2	The Legend of Zorro
夢魘情人	Beastly
軍犬麥斯	Max
決勝女王	Molly's Game 
我的火星小孩	Martian Child
馬克白	Macbeth
我是傳奇	I Am Legend
愛國者行動	Patriots Day 
波灣陰謀	Redacted
異形:聖約	Alien: Covenant
巴黎電幻世代	Eden
愛你愛到快抓狂	The Upside of Anger
迷走星球	Zathura
好萊塢的黑名單	Trumbo
讓愛飛起來	Ricky
如果我想吹口哨	If I Want to Whistle, I Whistle 
門當父不對3	Meet the Fockers
鬼哭神嚎	Poltergeist
雄辯天下	The Great Debaters
紅潮入侵	Red Dawn
字畫情緣	Words and Pictures
薩拉邦德舞曲	Saraband
魔髮精靈	Trolls
贖罪	Atonement
怪物	Victor Frankenstein
死亡筆記本	Death Note 
慾望城市電影版	Sex and the City: The Movie
關鍵少數	Hidden Figures
混沌理論	Chaos Theory
賭城最後一夜	Last Vegas
白鯨傳奇	In the Heart of the Sea
獨領風潮	Take the Lead
我愛故我在	I Am Love
想愛趁現在	A Little Bit of Heaven
瘋一樣的男子	Like Crazy
人生剩利組	Brad's Status
真愛之吻	Penelope
魔境冒險3D	The Nutcracker in 3D
夢想奔馳	Dreamer: Inspired by a True Story
託陰	The Boy 
愛與黑暗的故事	A Tale of Love and Darkness 
納尼亞傳奇3	The Chronicles of Narnia: 
星際禁區	The Last Days on Mars 
海邊的曼徹斯特	Manchester by the Sea 
放浪春假	Spring Breakers
危牆狙擊	The Wall 
伴郎友沒友	The Wedding Ringer
我的老爸喵星人	Nine Lives 
肌膚之侵	Under the Skin 
魅惑	The Beguiled
魔鏡魔鏡	Mirror Mirror
通往關達那摩之路	The Road to Guantanamo
西遊：降魔篇	Journey to the West: Conquering the Demons
竊盜	The Town
驚狂十一月	November
巴黎窈窕熟女	My Old Lady
馬達加斯加2	Madagascar: Escape 2 Africa
凸種高材生2	Van Wilder 2: The Rise of Taj
人形蜈蚣2	The Human Centipede II 
水性楊花	Easy Virtue
別相信任何人	Before I go to sleep
沉默一瞬	The Look of Silence
蝙蝠俠:致命玩笑	Batman: The Killing Joke 
匹茲堡的秘密	The Mysteries of Pittsburgh
沉默的雙眼	Secret in Their Eyes 
貧民百萬富翁	Slumdog Millionaire
我是女生,也是男生	XXY
金臂美國夢	Million Dollar Arm 
彗星來的那一夜	Coherence
驅魔神探	Constantine
崔斯坦與依索德	Tristan & Isolde
玩命記憶	Unknown
功夫拳霸	Dynamite Warrior 
快樂告別的方法	The Farewell Party
命運鞋奏曲	The Cobbler
樂高炫風忍者電影	The Lego Ninjago Movie
扭轉時光機2	Hot Tub Time Machine 2
震撼效應	In the Valley of Elah
哈利波特4	Harry Potter and the Goblet of Fire
我的夏日戀曲	My Summer of Love 
蜜月玩很大	Random Tropical Paradise 
七夜怪譚	Rings
蘋果	Lost in Beijing
陰宅	The Amityville Horror 
迷宮	Pan's Labyrinth
實習大叔	The Internship 
里約大冒險	Rio
遇上比爾	Meet Bill
幸運之吻	Just My Luck
梅格漢的心靈鑰匙	Manglehorn
怪物的孩子	The Boy and The Beast
美女與野獸3D	Beauty and the Beast 3D
合法入侵	Lakeview Terrace
沒問題先生	Yes Man
魔鬼命令4	Universal Soldier: Day of Reckoning 
皮巴弟先生與薛曼的時光冒險	Mr. Peabody & Sherman
小紅帽	Hoodwinked
愛在回家時	A Family Man
追兇	November Criminals 
寵物當家	The Secret Life of Pets 
巧克力冒險工廠	Charlie and the Chocolate Factory
雙面諜	The Double
雙面人質	I Know Who Killed Me
從此沒有過著幸福快樂的日子	Happily N'Ever After 
衝刺終點線	McFarland, USA 
激情	Passion
黑眼圈	I Don't Want to Sleep Alone 
踹球叫練	Kicking & Screaming
控制	Gone Girl 
神偷奶爸2	Despicable Me 2
關鍵真相	Truth
想飛的鋼琴少年	Vitus
口是心非	Duplicity
血戰12輪	12 Rounds
凱爾斯的秘密	The Secret of Kells
搖滾時代	Rock of Ages 
反恐戰場	The Kingdom
三個傻瓜	3 Idiots
終極災難電影	Disaster Movie
鬼水	Dark Water
聖誕快樂又瘋狂3	The Santa Clause 3
龐貝:最後之日	Pompeii
星際爭霸戰3	Star Trek 3
猩球崛起3	War for the Planet of the Apes
猛男姦獄	Big Stan
決戰異世界3	Underworld: Rise of the Lycans
反恐精英	The Raid 
丑男大丈夫	Klown
光榮戰警	Pride and Glory
模範大哥哥	Role Models
歡樂好聲音	Sing
戰爭製造公司	War, Inc.
飆風天王	The Dukes of Hazzard
大英雄天團	Big Hero 6
刺客任務	Hitman: Agent 47
大法官	The Judge
星際大戰第三部曲	Star Wars: Episode III - Revenge of the Sith 
轟炸街頭	Bomb the System
熱街勁舞	Rize 
當櫻花盛開	Cherry Blossoms 
婦仇者聯盟	The Other Woman 
聖杯騎士	Knight of Cups
冰原歷險記3	Ice Age: Dawn of the Dinosaurs
別闖陰陽界	Flatliners
街舞開戰	Planet B-Boy
一路靠北	Ride Along 
逐愛角落	The Refuge
惡棍狙擊	The Debt
充氣娃娃之戀	Lars and the Real Girl
妳的樣子	Away From Her
冤家囍相逢	You Again
夢遊亞馬遜	Embrace of the Serpent
寵物情人	Unleashed
命運規劃局	The Adjustment Bureau
前陷風暴	Beaufort
星塵情緣	Stardust
蟻人	Ant-Man 
玩命再劫	Baby Driver 
地鐵迷宮	Kontroll
英倫對決	The Foreigner
撕眠	Before I Wake 
老男孩	Oldboy
三更2	Three...Extremes 
尖叫旅社2	Hotel Transylvania 2 
甜心大姐頭	The Boss 
人生雙告急	The Skeleton Twins 
鬼哭狼嚎2	Wolf Creek 2
飆速青春	Whip It
怒火邊界	Sicario
地心冒險2	Journey 2: The Mysterious Island
為你流的淚	Keep The Lights On
尋找夢奇地	Bridge to Terabithia
太極	Taichi 0
綁架	Kidnap
正宗哥吉拉	Godzilla Resurgence 
飢餓遊戲3.2	The Hunger Games: Mockingjay - Part 2
與森林共舞	The Jungle Book 
巴黎小情歌	Love Songs 
代號:華爾奇麗亞	Valkyrie
不願面對的真相	An Inconvenient Truth
女王與知己	Victoria and Abdul
惡靈嬰弒	Devil's Due   
男人行不行2	Think Like a Man Too 
有你,生命最完整	The Best of Me
印象雷諾瓦	Renoir
被遺忘的1937	Nanking
愛情齡距離	Home Again
殺人一舉	The Act of Killing 
丁丁歷險記	The Adventures of Tintin: Secret of the Unicorn
稀人	Marebito
尼魔島	Nim's Island
百貨戰警2	Paul Blart: Mall Cop 2
美國幫派	American Gangster
伊媚兒新娘	Mail Order Wife 
青春誓言	Testament of Youth 
皇家風流史	A Royal Affair
繼父疼死你	The Stepfather 
愛情對白	Certified Copy 
戀夏進行式	The Spectacular Now 
超級狐狸先生	The Fantastic Mr. Fox
情慾二重奏	The Last Mistress 
金牌手	Gambit
聚魔櫃	The Possession
陰兒房	Insidious
全面鎖定	Closed Circuit
醉後大丈夫2	The Hangover Part II
為了與你相遇	A Dog's Purpose 
瞞天殺機	Serena
泰特羅	Tetro
黃金羅盤	Golden Compass
偷穿高跟鞋	In Her Shoes
迷懵夢寐	Martha Marcy May Marlene
傲慢與偏見	Pride and Prejudice
四虎出閘	Four Brothers
傷心往事	House of D 
移動迷宮	The Maze Runner
吹動大麥的風	The Wind That Shakes the Barley
傑克萊恩	Jack Ryan
雲端情人	Her
放逐	Exiled 
浮世傷痕	The Immigrant 
盲目約會	Blind Dating
梭哈人生	A Hologram for the King 
輕輕搖晃	Lilting
世界	The World
失速人生	Locke
愛情你我她	Me and You and Everyone We Know 
渾身是勁2011	Footloose
捉妖記	Monster Hunt
刺客聶隱娘	The Assassin
維多利亞女皇情史	The Young Victoria 
黑道比酷	Be Cool
勇士傳奇	Beowulf & Grendel 
雪天使	Snow Angels
舊夢	Old Joy
純真的聲音	Innocent Voices 
絕地救援	The Martian
前嫌盡弒	Final Girl
下流正義	The Lincoln Lawyer 
姣妹日記	The People I've Slept With 
狡兔計畫	Safe House
鐵達尼號3D版	Titanic 3D
飛機總動員2	Planes: Fire & Rescue
特種部隊2	G.I. Joe 2: Retaliation 
荒島魔咒	Magic Magic 
功夫熊貓3	Kung Fu Panda 3
薩利機長	Sully
顛倒世界	Upside Down
金盞花大酒店2	The Second Best Exotic Marigold Hotel
魔法黑森林	Into the Woods
遠離阿雅米	Ajami
小熊維尼電影版	Winnie the Pooh
未婚媽媽	Stephanie Daley
家傳秘方	The Secret of the Grain 
鬼來電西洋篇	One Missed Call 
星際異攻隊	Guardians of the Galaxy
天倫之旅	Everybody's Fine
禁愛世界	Equals
酷狗馬馬杜	Marmaduke
偽幣製造者	The Counterfeiters 
時尚惡魔的聖經	The September Issue
特務大臨演	The Brothers Grimsby
一千次晚安	A Thousand Times Good Night
奪魂鋸2	Saw 2
吸血鬼腥靈診療	Therapy for a Vampire
洛基6	Rocky Balboa
突變末日	The Mutant Chronicles 
愛情昏迷中	The Big Sick 
交響人生	The Concert 
空中危機	Flightplan
天啟四騎士	The Horsemen
汽車總動員2	Cars 2
震撼擂台	Southpaw
飆風雷哥	Rango
玩命直播	Nerve
愛在頭七天	This is Where I Leave You
看看我聽聽我	Look at Me 
終極警探4	Live Free or Die Hard
邁阿密風雲	Miami Vice
羅丹薩的夜晚	Nights in Rodanthe
我仍在這裡	I'm Still Here
妮嘉	Neerja
博物館驚魂夜	Night at the Museum
妙媳婦見公婆	Junebug 
一路靠北2	Ride Along 2
捉迷藏	Hide and Seek
蘇西的世界	The Lovely Bones 
真實的勇氣	True Grit
星光大盜	The Bling Ring
全境警戒	Bushwick
奇光下的秘密	Wonderstruck
天皇	Emperor
4月3週又2天	4 Months, 3 Weeks and 2 Days 
奧茲大帝	Oz: The Great and Powerful 
吻兩下打兩槍	Kiss Kiss, Bang Bang
鋼鐵力士	Hercules: The Legend Begins 
限時救援	Sleepless
出埃及記	Exodus: Gods and Kings
幻影殺手	Elektra
遺忘故都	The Lost City
亂世傷痕:末代總督的秘密	Viceroy's House 
下一秒	Next
年輕氣盛	Youth
生命之詩	Poetry
他其實沒那麼喜歡妳	He's Just Not That Into You
鬼敲門	The Babadook
孤兒怨	Orphan
美人魚	The Mermaid 
企鵝寶貝	March of the Penguins 
決戰日	Day Watch
柯羅索巨獸	Colossal
隔壁的男孩殺過來	The Boy Next Door 
一飛沖天	Rocket Science
失速夜狂奔	Good Time
屍控奇幻旅程	Swiss Army Man 
婚禮終結者	Wedding Crashers
食破天驚	Cloudy with a Chance of Meatballs
愛在羅馬	To Rome with Love 
功夫之王	The Forbidden Kingdom
性福療程	The Sessions
越野狂飆	Supercross
舞孃俱樂部	Burlesque
原子小金剛	Astro Boy
惡鄰古堡	Straw Dogs
西班牙公寓2	The Russian Dolls
鬼遮眼	Oculus
極速快感	Need For Speed 
心靈獨奏	The Soloist
亡命西伯利亞	Transsiberian
霍爾的移動城堡	Howl's Moving Castle 
斷魂谷	Wind Chill
星際異攻隊2	Guardians of the Galaxy Vol. 2
深海鯊機	47 Meters Down 
非關入學	Admission
三個大丈夫	You Won’t Get to Live Twice
絕地奶霸2	Big Momma's House 2
三月封面女郎	Miss March
泰山傳奇	The Legend of Tarzan
夜行人生	Live by Night 
安娜華特	The Faith of Anna Waters
格雷的五十道陰影3	Fifty Shades Freed 
來信情緣	Dear  Frankie
一日一生	labor day
曾經,樂是唯一	Begin Again
凍死骨	Winter's Bone
小賈斯汀:挑戰不可能	Justin Bieber: Never Say Never
人形蜈蚣3	The Human Centipede 3
小熊出擊	Bad News Bears
玩命關頭6	Fast & Furious 6
碟仙2	Ouija 2
終極戰士3	Predators
如果我留下	If I Stay 
舞力全開5	Step Up All In
魔咒鬼屋	House
一年之癢	I Give It a Year
料理絕配	No Reservations
美國刺客	American Assassin 
怪怪惹人愛	Some Freaks 
殭屍哪有這麼正	Life after Beth
死侍	Deadpool
嗑到荼蘼	Enter the Void
羅密歐與茱麗葉	Romeo and Juliet 
智慧戰爭	Flash of Genius
絨毛團	Plush
無處可逃	No Escape 
大愛晚成	Laggies
瑪格麗特	Margaret
有完沒完	Are We Done Yet?
哈比人3	The Hobbit: The Battle of the Five Armies
冬至	Winter Solstice
烽火孿生淚	Twin Sisters 
靈魂衝浪	Soul Surfer
湄公河行動	Operation Mekong
狂愛姊妹花	Beloved Sisters
藍色小精靈2	The Smurfs 2
牠	It
姚明來了	The Year of the Yao 
豬頭漢堡飽2	Harold and Kumar Escape From Guantanamo
進退兩難	The Dilemma
巨震過後	Aftershock
愛倫坡懸案	The Raven
惡靈古堡5	Resident Evil: Retribution
神奇大隊長	Captain Fantastic 
MIB星際戰警3	Men in Black III
急凍邊境	Frozen River
聖誕好家在	Love the Coopers
神仙家庭	Bewitched
咖啡愛情	Café Society 
公主與青蛙	The Princess and the Frog
神鬼奇航5	Pirates of the Caribbean: Dead Men Tell No Tales
鍋蓋頭	Jarhead
戀戀酒鄉	Bottle Shock
不再克制	Control
消失在第七大街	Vanishing on 7th Street
魔鬼終結者5	Terminator: Genesis 
山河故人	Mountains May Depart
馴龍高手2	How to Train Your Dragon 2
頭號冤家	One for the Money
阿泥正傳	Mud
紐約愛未眠	Before We Go 
哈利波特7.2	Harry Potter and the Deathly Hallows - Part 2
王牌推銷員	The Goods: Live Hard. Sell Hard.
時光逆侶	Youth Without Youth
透納先生	Mr. Turner
夜三十	30 Days of Night
婚約裂痕	Separate Lies
復仇者聯盟3	Avengers: Infinity War 
拉合爾茶館的陌生人	The Reluctant Fundamentalist 
毛毛狗	Doogal
無厘取鬧:阿公壞壞	Bad Grandpa 
我一直深愛著你	I've Loved You So Long
基努賤隊	Keanu
亞果出任務	Argo
活埋	Buried
撒旦的情與慾	Antichrist
我們撞到外星人	Paul
怒海劫	Captain Phillips
百貨戰警	Paul Blart: Mall Cop
莎拉波莉家庭詩篇	Stories We Tell 
荷頓奇遇記	Dr. Seuss' Horton Hears a Who
貓頭鷹守護神	Legend of the Guardians
吹夢巨人	The BFG
疾速救援	The Commuter
彼得與溫蒂之戀	Peter and Vandy
愛,從心開始	Last Chance Harvey
被出賣的台灣	Formosa Betrayed
第一夫人的秘密	Jackie
暗擁	Undertow
末日迷蹤	Left Behind
我不是潘金蓮	I Am Not Madame Bovary
選戰風雲	The Ides of March
鳥人	Birdman
限制級戰警3	xXx: The Return of Xander Cage 
陌路狂殺	The Strangers
咎愛	The Past
最後大法師	The Last Exorcism
顛父人生	Toni Erdmann 
美男子	Bel Ami
蝙蝠俠:開戰時刻	Batman Begins 
1世代	One Direction: This Is Us
給茱麗葉的信	Letters to Juliet
剎靈	The Ring Two
失蹤人口	Gone Baby Gone
安娜貝爾2	Annabelle 2
第四公民	Citizenfour
我只是個計程車司機	A Taxi Driver
賽德克巴萊	Seediq Bale
黃金時代	The Golden Era
媽媽咪呀2	Mamma Mia! Here We Go Again 
V怪客	V For Vendetta
詭影訪客	Alien Abduction 
鐵道飛虎	Railroad Tigers
錄到鬼4	[REC] 4: Apocalipsis
蜜月變奏曲	A Perfect Getaway
極速秒殺2	Mechanic: Resurrection
黑塔	The Dark Tower
撕裂人	Slither
老闆不是人2	Horrible Bosses 2 
破綻	Fracture
美國隊長	Captain America: The First Avenger
還有機會說再見	Before I Fall 
精選完美男	The Switch
傻愛成金	Fool's Gold
親愛的小孩	The Boys Are Back
打不倒的勇者	Invictus
冰原歷險記4	Ice Age: Continental Drift
鬼迷心竅	Obsessed
決戰異世界4	Underworld 4
玩命關頭7	Fast & Furious 7 
與陌生女子調情	Conversations with Other Women
客製化女神	Ruby Sparks
愛愛小確性	The Little Death 
地獄新娘	Tim Burton's Corpse Bride
舞力重擊	High Strung 
鬼不理的助手	Cirque Du Freak: The Vampire's Assistant
酷寶:魔弦傳說	Kubo and the Two Strings
月球暗面	In the Shadow of the Moon
關鍵救援:巴士657	Bus 657
外慾殺機	The Other Man 
39特案	Case 39
超人再	Superman Returns 
魔鬼契約	Heartless
凶兆2:雙瘋	Sinister 2
3D龍門飛甲	The Flying Swords of Dragon Gate
摩納哥王妃	Grace of Monaco
全面突襲2	The Raid 2: Berandal 
銀幕大角頭2	Anchorman 2: The Legend Continues
裝璜東西軍	Deck the Halls
愛在波蘭戰火時	Katyn
燦爛時光	The Best of Youth
跨界失控	Welcome To Yesterday 
終極警探5	A Good Day to Die Hard
月球漫遊	Moon
英雄教育	Before the Fall
沉默之丘	Silent Hill
資本主義	Capitalism: A Love Story
非禮勿弒	The Gift 
魔法褓母麥克菲	Nanny McPhee
自由鳥	Free Birds 
垂死的高盧人	The Dying Gaul
幽靈終結者	The Hitcher
色慾修道院	The Little Hours
波特小姐	Miss Potter
雨果的冒險	Hugo
生死一擊	Killshot
愛無止期	Time to Leave
地平線	Deepwater Horizon
為妳唱的歌	Song to Song
冰刀雙人組	Blades of Glory
逃離邊境	The Homesman 
最好的時光	Three Times
梵諦岡影帶	The Vatican Tapes 
舞法舞天2	Step Up 2 the Streets
吸血鬼就在隔壁3D	Fright Night
鯨奇之旅	Big Miracle
未來的未來	This Is It 
久美子的奇異旅程	Kumiko, the Treasure Hunter
馬達加斯加爆走企鵝	The Penguins of Madagascar 
愛在他鄉	Brooklyn
世界唯一的你	My One and Only
12猛漢	12 Strong
她的私密日記	The Private Lives of Pippa Lee
無畏之心	A Mighty Heart
性本愛	Love
鬼門開	The Other Side of the Door
靈動檔案	The Awakening
請問布希大人	W.
奪魂鋸6	Saw VI
格雷的五十道陰影	Fifty Shades of Grey 
強納斯兄弟演唱會	Jonas Brothers:The 3D Concert Experience
鏽與骨	Rust & Bone
愛情逃兵	Love and Honor
刀劍神域劇場版－序列爭戰	Sword Art Online the Movie: Ordinal Scale
魔鬼知道你死前	Before the Devil Knows You're Dead
深入絕地	The Descent
驗屍官	The Autopsy of Jane Doe 
世界屬於我們	Were the World Mine 
爆裂警官	The Bad Lieutenant: Port of Call New Orleans
飢餓遊戲	The Hunger Games
下女	The Housemaid
非婚生子	Friends with Kids 
七龍珠	Dragonball
機關槍傳教士	Machine Gun Preacher
濃情威尼斯	Casanova
避風港	Shelter
神隱任務	Jack Reacher
走私人口	Trade
兩天一夜	Two Days, One Night
進擊的鼓手	Whiplash
叛國者	Traitor
長城	The Great Wall 
玩命關頭8	Furious 8
怪獸卡車	Monster Trucks 
惡煞臨門	No Good Deed 
購物狂的異想世界	Confessions of a Shopaholic
摯愛無盡	A Single Man
末日情緣	Perfect Sense 
真愛旅程	Revolutionary Road
海神號	Poseidon
國王人馬	All The King's Men
摩天樓	High-Rise 
正義聯盟	Justice League
空屋情人	3-Iron 
絕命終結站4	Final Destination: Death Trip 3D
分歧者	Divergent
玩命關頭4	Fast and Furious
奪魂鋸3	Saw III
限時翻供	Snitch
無極	The Promise
驚爆萬惡城	Edge of Darkness 
情遇巴塞隆納	Vicky Cristina Barcelona
戀愛救火隊	Heartbreaker
謀殺球	Murderball
狼嚎再起	The Wolfman
烈火擎天	Burning Blue 
性謀殺天使城	The Informers
罪惡之城娥摩拉	Gomorra
時光叛逃者	Time Renegades
永生書	The Book of Eli
年少時代	Boyhood
華爾街2	Wall Street: Money Never Sleeps
妖物	SiREN
情慾三重奏	Third Person 
金色大門	Golden Door
阿姐響叮噹	A Bad Moms Christmas 
走鋼索的人	The Walk
竊車犯	Stealing Cars 
第七傳人	Seventh Son
帕納大師的魔幻冒險	The Imaginarium of Doctor Parnassus
降世錄	The Nativity Story
熊麻吉2	Ted 2 
替天行盜	The Edukators
傑克與羅絲的民謠	The Ballad of Jack and Rose 
世貿中心	World Trade Center
新郎不是我	Made of Honor
黃石任務	The Children of Huang Shi 
藝妓回憶錄	Memoirs of a Geisha 
真愛戀習曲	Song One 
少女離家記	Mustang
食人煉獄	The Green Inferno
黑豹	Black Panther 
異形鬼屋	Alone in the Dark
五日戰爭	5 Days Of War 
成名終點站	Gus Van Sant's Last Days 
24小時殺到爆	24 Hours to Live
超異能冒險	Race to Witch Mountain
惡靈金庫	The Vault
辦公室大狂殺	The Belko Experiment 
永不放棄	Won't Back Down
全境擴散	Contagion
邪靈刑事錄	Regression
殭屍小屁孩	Cooties
天菜大廚	Burnt
舞力全開4	Step Up 4
凡爾賽拜金女	Marie Antoinette
愛愛上雲端	Sex Tape
面子	Saving Face
X戰警:金鋼狼	X-Men Origins: Wolverine
麥迪遜錦標賽	Madison 
麻辣賤諜	Spy
迴路殺手	Looper
波普先生的企鵝	Mr. Popper's Penguins
逆轉人生	The Intouchables
數字戰	The Numbers Station
黑魔女:沉睡魔咒	Maleficent
吸血鬼家庭詩篇	What We Do In The Shadows
法海:白蛇傳說	The Sorcerer and the White Snake
拳霸3	Ong bak 2 
拳霸終極篇	Ong-Bak 3
愛麗絲人間蒸發	The Disappearance of Alice Creed
光榮歲月	Indigènes
魔幻奇緣	Death Defying Acts 
滅絕	Annihilation
非關命運	Fateless
絕地奶霸3	Big Mommas: Like Father, Like Son
鬼屋入鏡	A Haunted House
地獄魔咒	Drag Me to Hell
暴風雪中的白鳥	White Bird in a Blizzard 
遠離塵囂	Far from the Madding Crowd
閃靈俠	The Spirit
非常衝突	Sleuth
鬼入鏡5	Paranormal Activity: The Ghost Dimension 
金牌特務2	Kingsman: The Golden Circle
無敵破壞王	Wreck-It Ralph 
我心遺忘的節奏	The Beat That My Heart Skipped
同室操戈	War Room
尋龍傳說	Pete's Dragon
蝙蝠	Thirst
血獵人	Rise: Blood Hunter
荒涼大地	The Dry Land
廢墟	The Abandoned
驚悚末日	Melancholia 
紐約哈哈哈	Frances Ha 
殺死我吧	You Kill Me
小鬼也摩登	Son of the Mask
圓夢旅程	Rudo y Cursi
亞歷珊卓	Alexandra
全民情聖	Hitch
愛情必修學	Liberal Arts
亞當	Grown Ups
神鬼尖兵2	The Boondock Saints II: All Saints Day
翁山蘇姬	The Lady
街頭日記	Freedom Writers
女獸人	The Woman
異族終結戰	Skinwalkers
寶貝老闆	The Boss Baby 
女僕	The Maid
姐姐我醉大	Walk of Shame
心魔	The Devil Inside
屬於我們的聖誕節	A Christmas Tale
納粹龐克	Green Room 
青春轉大人	Youth in Revolt
單身啪啪啪	How to Be Single 
非常上訴	Conviction
限制級戰警2	XXX: State of the Union
鬼屋泰淒厲	Ghost House
心花漾	Something New
聖誕快遞	Arthur Christmas
間諜大鄰演	Keeping Up with the Joneses
鞋貓劍客	Puss in Boots
吸血萊恩	BloodRayne
雷霆戰狗	Bolt
薰衣草夫人	Ladies in Lavender
百戰天蟲	MacGruber
盜夢偵探	Paprika
火線反擊	Safe
色遇	The Tourist
換腦行動	Criminal
諜報風雲	A Most Wanted Man 
海底世界	Deep Blue 
吾愛無悔	The Black Balloon
蝙蝠俠對超人	Batman v Superman: Dawn of Justice
窒命地	Colonia
波西傑克森:神火之賊	Percy Jackson & The Olympians: The Lightning Thief
導火線	Flash Point 
變形金剛2	Transformers: Revenge of the Fallen
我的屍控女友	Burying the Ex 
巴黎二日情	2 Days in Paris
臥虎藏龍2	Crouching Tiger, Hidden Dragon: The Green Legend
斑馬快跑	Racing Stripes
親愛媽咪	Mommy
暮光之城	Twilight
女模煞	Domino
王者之聲	The King's Speech
3D食人魚	Piranha 3-D
諜影行動	Tinker, Tailor, Soldier, Spy
長毛狗	The Shaggy Dog
野蠻大對決	Furry Vengeance
功夫鐵拳	The Man with the Iron Fists
菸草之王	Thank You for Smoking
鬪犬	Unleashed
沉默之丘2	Silent Hill: Revelation 3D 
泳往直前	Swimming Upstream 
走音天后	Florence Foster Jenkins 
網美嬉遊記	Ingrid Goes West 
亞瑟	Arthur and the Invisibles
寶貝超級壞	Nasty Baby
玩命法則	The Counselor
雲端男女	Men, Women & Children
記憶傳承人	The Giver
異旅情絲	Silk
33:重生奇蹟	The 33
美麗拳王	Beautiful Boxer 
謎樣女孩死亡事件	The Dead Girl
百萬嬌妻綁架計畫	Life of Crime 
最黑暗的時刻	Darkest Hour 
瘋狂理髮師	Sweeney Todd: The Demon Barber of Fleet Street
圖班嫁給我	Tulpan
葉問	Ip Man 
萌牛費迪南	Ferdinand
謎走愛情	The Disappearance of Eleanor Rigby
隔離島	Shutter Island
雷的五十道黑影	Fifty Shades of Black 
屍變	Evil Dead
羅馬不思議	When in Rome
超急快遞	Premium Rush
辣味雙拼	Hot Pursuit
X戰警:變蟲人	Bite
全民超人	Hancock
瑞秋要出嫁	Rachel Getting Married 
星艦戰將:火星叛徒	Starship Troopers: Traitor of Mars
監守自盜	The Lookout
我媽的希臘婚禮	My Big Fat Greek Wedding 2
讓子彈飛	Let the Bullets Fly 
鋼鐵英雄	Man of Steel
鬼訊號	White Noise 
驚聲尖笑5	Scary Movie 5
星際大戰7	Star Wars: Episode VII 
飢餓	Hunger
姊姊的守護者	My Sister's Keeper
極地追擊	Wind River
拜金女孩	Material Girls
哈啦上菜	Waiting
虐殺	Chaos 
紐澤西男孩	Jersey Boys 
備胎女王	The Back-up Plan
海底總動員3D	Finding Nemo 3D
大學生了沒	College Road Trip
火線對峙	Hostage
醉後大丈夫3	The Hangover Part III
巴黎蒙田大道	Avenue Montaigne
吉屋出租	Rent 
啦妹當家	Man of the House
與巴席爾跳華爾滋	Waltz with Bashir
樂來越愛你	La La Land
好運汪汪來	Year of the Dog
變奏曲	Brothers
靈動:鬼影實錄	Paranormal Activity
殺死達令	Kill Your Darlings
猩球崛起	Rise of the Apes
艾美懷絲	Amy
紐約唯一	The Only Living Boy in New York
天才神算	Imagine That
BJ有喜	Bridget Jone's Baby
監視	Surveillance
戀愛學分	Starter for 10
歐羅巴報告	Europa Report 
我愛斷背衫	Cut Sleeve Boys
曼哈頓	The Good Guy 
選擇	Sympathy for Lady Vengeance
拖油瓶	Cyrus
無法無天2	City of Men
惡靈戰警2	Ghost Rider: Spirit of Vengeance
3D血腥情人節	My Bloody Valentine 3-D
奇特女孩	Kit Kittredge: An American Girl
借物少女艾莉緹	The Borrowers 
寂寞公路	The End of the Tour 
尋找甜秘客	Searching For Sugar Man
法蘭克	Frank
汙點	Dirty
鬼屋電影2	A Haunted House 2
辛普森家庭電影版	The Simpsons Movie
晴空戰士	Sky Blue 
一級玩家	Ready Player One
搶救千金	Snatched
魔咒	Cursed
血鑽石	Blood Diamond
超狂亨利	Hardcore Henry 
白象:無法之城	White Elephant
美人情園	A Little Chaos
肝膽相照	The Matador
模仿遊戲	The Imitation Game 
遺落汪洋	All is Lost 
開運兔	Hop
帝國毀滅	Downfall 
神鬼認證4	The Bourne Legacy
居安思危	Take Shelter
黑心交易員的告白	Margin Call
靈犬萊西	Lassie
永夜魔女	The Lazarus Effect
霸凌女教師	Bad Teacher
雪人	The Snowman
陳真:精武風雲	Legend of the Fist: The Return of Chen Zhen
時尚大師聖羅蘭	Yves Saint Laurent
新娘向後跑	Imagine Me & You
變形金剛3	Transformers: Dark of the Moon
8面埋伏	Mindhunters
窈窕老爸	Transamerica
騷莎大塊呆	Cuban Fury
衝出康普頓	Straight Outta Compton
澳大利亞	Australia
一噤到底美國版	Silent House
糯米正傳	Norbit
切膚慾謀	The Skin I Live In
狂野三人行	Wild Side
大吉嶺特快車	The Darjeeling Limited
X戰警3	X-Men 3
超時空戰警3D	Dredd
旅行之歌	Grbavica
歿日冰封	The Last Winter
凶兆	Sinister
神通魔法石	Shorts
玩命一擲	Uncertainty
情聖終結者	Spread
雙面翻譯	The Interpreter
放牛班快樂頌	Paris 36 
凸搥特派員2	Johnny English Reborn 
木乃伊博物館	Mother of Tears 
巴黎換換愛	The Valet
命中注定遇見愛	You Will Meet a Tall Dark Stranger
偷情閣樓	The Loft
刺客教條	Assassin's Creed 
再見羅賓	Goodbye Christopher Robin
陰兒房第4章	Insidious 4: The Last Key 
聖誕狂歡夜	The Night Before 
千言萬語	A Thousand Words
森林保衛戰	Over the Hedge
分裂	Split
普羅米修斯	Prometheus
人魔	Hannibal Rising
浮華陷阱	Savage Grace
我和我的小鬼們	The Class
哈比人2	The Hobbit: The Desolation of Smaug 
寶貝媽媽	Baby Mama
大象的眼淚	Water for Elephants
蜘蛛人:新宇宙	Spider-Man: Into the Spider-Verse
八月	August: Osage County 
烈血風雲	Blood Ties
關鍵目擊	Parkland
科洛弗10號地窖	10 Cloverfield Lane
我行我愛	Somersault 
愛•穹蒼	To the Wonder
玩火的女孩	The Girl Who Played with Fire
烏賊與鯨	The Squid and the Whale
玩命關頭3	The Fast and the Furious: Tokyo Drift
即刻反擊	Haywire
姐姐妹妹殺起來	Tragedy Girls
金剛:骷髏島	Kong: Skull Island
超狗任務	Underdog
誘鯊	Bait 3D
巴霍巴利王2	Bahubali 2: The Conclusion
驚天巨浪	The Wave
瞞天大佈局	American Hustle
馴龍高手	How to Train Your Dragon
大明星世界末日	This is the End
黃沙武士	The Warrior's Way
神愛弒人	Red State
深入虎穴	Cronicas
機器人與法蘭克	Robot & Frank
殺手漢娜	Hanna
變種人	X-Men: The New Mutants
你是我的勇氣	Stronger
穿條紋衣的男孩	The Boy in the Striped Pajamas
間諜橋	Bridge of Spies 
派特森	Paterson
科學怪人	I, Frankenstein 
浴血任務	The Expendables 
噬血戀人	Only Lovers Left Alive
德古拉:永咒傳奇	Dracula Untold
謊言先師	The Invention of Lying
納尼亞傳奇2	The Chronicles of Narnia: Prince Caspian
愛情混音師	In the Mix
搖滾世代	Glastonbury
大亨偽傳	The Hoax
真愛有夠殺	Mr. Right 
13搏命遊戲	13
錯的多美麗	Clean
黑色大理花懸案	The Black Dahlia
疾風禁區2	Goal! 2: Living the Dream... 
風雲人物	Man of the Year
28週毀滅倒數	28 Weeks Later
降世神通	The Last Airbender
